type octile
height 84
width 170
map
TTTTTTTTTTTTTTTTTTTTTTTTTTTTTTTTTTTTTTTTTTTTTTTTTTTTTTTTTTTTTTTTTTTTTTTTTTTTTTTTTTTTTTTTTTTTTTTTTTTTTTTTTTTTTTTTTTTTTTTTTTTTTTTTTTTTTTTTTTTTTTTTTTTTTTTTTTTTTTTTTTTTTTTTTT
T........................................................................................................................................................................T
T........................................................................................................................................................................T
T.........................TTTTTTTTTT..TTTTTTTTTT..TTTTTTTTTT..TTTTTTTTTT..TTTTTTTTTT..TTTTTTTTTT..TTTTTTTTTT..TTTTTTTTTT..TTTTTTTTTT..TTTTTTTTTT.........................T
T.........................TTTTTTTTTT..TTTTTTTTTT..TTTTTTTTTT..TTTTTTTTTT..TTTTTTTTTT..TTTTTTTTTT..TTTTTTTTTT..TTTTTTTTTT..TTTTTTTTTT..TTTTTTTTTT.........................T
T........................................................................................................................................................................T
T........................................................................................................................................................................T
T.........................TTTTTTTTTT..TTTTTTTTTT..TTTTTTTTTT..TTTTTTTTTT..TTTTTTTTTT..TTTTTTTTTT..TTTTTTTTTT..TTTTTTTTTT..TTTTTTTTTT..TTTTTTTTTT.........................T
T.........................TTTTTTTTTT..TTTTTTTTTT..TTTTTTTTTT..TTTTTTTTTT..TTTTTTTTTT..TTTTTTTTTT..TTTTTTTTTT..TTTTTTTTTT..TTTTTTTTTT..TTTTTTTTTT.........................T
T........................................................................................................................................................................T
T........................................................................................................................................................................T
T.........................TTTTTTTTTT..TTTTTTTTTT..TTTTTTTTTT..TTTTTTTTTT..TTTTTTTTTT..TTTTTTTTTT..TTTTTTTTTT..TTTTTTTTTT..TTTTTTTTTT..TTTTTTTTTT.........................T
T.........................TTTTTTTTTT..TTTTTTTTTT..TTTTTTTTTT..TTTTTTTTTT..TTTTTTTTTT..TTTTTTTTTT..TTTTTTTTTT..TTTTTTTTTT..TTTTTTTTTT..TTTTTTTTTT.........................T
T........................................................................................................................................................................T
T........................................................................................................................................................................T
T.........................TTTTTTTTTT..TTTTTTTTTT..TTTTTTTTTT..TTTTTTTTTT..TTTTTTTTTT..TTTTTTTTTT..TTTTTTTTTT..TTTTTTTTTT..TTTTTTTTTT..TTTTTTTTTT.........................T
T.........................TTTTTTTTTT..TTTTTTTTTT..TTTTTTTTTT..TTTTTTTTTT..TTTTTTTTTT..TTTTTTTTTT..TTTTTTTTTT..TTTTTTTTTT..TTTTTTTTTT..TTTTTTTTTT.........................T
T........................................................................................................................................................................T
T........................................................................................................................................................................T
T.........................TTTTTTTTTT..TTTTTTTTTT..TTTTTTTTTT..TTTTTTTTTT..TTTTTTTTTT..TTTTTTTTTT..TTTTTTTTTT..TTTTTTTTTT..TTTTTTTTTT..TTTTTTTTTT.........................T
T.........................TTTTTTTTTT..TTTTTTTTTT..TTTTTTTTTT..TTTTTTTTTT..TTTTTTTTTT..TTTTTTTTTT..TTTTTTTTTT..TTTTTTTTTT..TTTTTTTTTT..TTTTTTTTTT.........................T
T........................................................................................................................................................................T
T........................................................................................................................................................................T
T.........................TTTTTTTTTT..TTTTTTTTTT..TTTTTTTTTT..TTTTTTTTTT..TTTTTTTTTT..TTTTTTTTTT..TTTTTTTTTT..TTTTTTTTTT..TTTTTTTTTT..TTTTTTTTTT.........................T
T.........................TTTTTTTTTT..TTTTTTTTTT..TTTTTTTTTT..TTTTTTTTTT..TTTTTTTTTT..TTTTTTTTTT..TTTTTTTTTT..TTTTTTTTTT..TTTTTTTTTT..TTTTTTTTTT.........................T
T........................................................................................................................................................................T
T........................................................................................................................................................................T
T.........................TTTTTTTTTT..TTTTTTTTTT..TTTTTTTTTT..TTTTTTTTTT..TTTTTTTTTT..TTTTTTTTTT..TTTTTTTTTT..TTTTTTTTTT..TTTTTTTTTT..TTTTTTTTTT.........................T
T.........................TTTTTTTTTT..TTTTTTTTTT..TTTTTTTTTT..TTTTTTTTTT..TTTTTTTTTT..TTTTTTTTTT..TTTTTTTTTT..TTTTTTTTTT..TTTTTTTTTT..TTTTTTTTTT.........................T
T........................................................................................................................................................................T
T........................................................................................................................................................................T
T.........................TTTTTTTTTT..TTTTTTTTTT..TTTTTTTTTT..TTTTTTTTTT..TTTTTTTTTT..TTTTTTTTTT..TTTTTTTTTT..TTTTTTTTTT..TTTTTTTTTT..TTTTTTTTTT.........................T
T.........................TTTTTTTTTT..TTTTTTTTTT..TTTTTTTTTT..TTTTTTTTTT..TTTTTTTTTT..TTTTTTTTTT..TTTTTTTTTT..TTTTTTTTTT..TTTTTTTTTT..TTTTTTTTTT.........................T
T........................................................................................................................................................................T
T........................................................................................................................................................................T
T.........................TTTTTTTTTT..TTTTTTTTTT..TTTTTTTTTT..TTTTTTTTTT..TTTTTTTTTT..TTTTTTTTTT..TTTTTTTTTT..TTTTTTTTTT..TTTTTTTTTT..TTTTTTTTTT.........................T
T.........................TTTTTTTTTT..TTTTTTTTTT..TTTTTTTTTT..TTTTTTTTTT..TTTTTTTTTT..TTTTTTTTTT..TTTTTTTTTT..TTTTTTTTTT..TTTTTTTTTT..TTTTTTTTTT.........................T
T........................................................................................................................................................................T
T........................................................................................................................................................................T
T.........................TTTTTTTTTT..TTTTTTTTTT..TTTTTTTTTT..TTTTTTTTTT..TTTTTTTTTT..TTTTTTTTTT..TTTTTTTTTT..TTTTTTTTTT..TTTTTTTTTT..TTTTTTTTTT.........................T
T.........................TTTTTTTTTT..TTTTTTTTTT..TTTTTTTTTT..TTTTTTTTTT..TTTTTTTTTT..TTTTTTTTTT..TTTTTTTTTT..TTTTTTTTTT..TTTTTTTTTT..TTTTTTTTTT.........................T
T........................................................................................................................................................................T
T........................................................................................................................................................................T
T.........................TTTTTTTTTT..TTTTTTTTTT..TTTTTTTTTT..TTTTTTTTTT..TTTTTTTTTT..TTTTTTTTTT..TTTTTTTTTT..TTTTTTTTTT..TTTTTTTTTT..TTTTTTTTTT.........................T
T.........................TTTTTTTTTT..TTTTTTTTTT..TTTTTTTTTT..TTTTTTTTTT..TTTTTTTTTT..TTTTTTTTTT..TTTTTTTTTT..TTTTTTTTTT..TTTTTTTTTT..TTTTTTTTTT.........................T
T........................................................................................................................................................................T
T........................................................................................................................................................................T
T.........................TTTTTTTTTT..TTTTTTTTTT..TTTTTTTTTT..TTTTTTTTTT..TTTTTTTTTT..TTTTTTTTTT..TTTTTTTTTT..TTTTTTTTTT..TTTTTTTTTT..TTTTTTTTTT.........................T
T.........................TTTTTTTTTT..TTTTTTTTTT..TTTTTTTTTT..TTTTTTTTTT..TTTTTTTTTT..TTTTTTTTTT..TTTTTTTTTT..TTTTTTTTTT..TTTTTTTTTT..TTTTTTTTTT.........................T
T........................................................................................................................................................................T
T........................................................................................................................................................................T
T.........................TTTTTTTTTT..TTTTTTTTTT..TTTTTTTTTT..TTTTTTTTTT..TTTTTTTTTT..TTTTTTTTTT..TTTTTTTTTT..TTTTTTTTTT..TTTTTTTTTT..TTTTTTTTTT.........................T
T.........................TTTTTTTTTT..TTTTTTTTTT..TTTTTTTTTT..TTTTTTTTTT..TTTTTTTTTT..TTTTTTTTTT..TTTTTTTTTT..TTTTTTTTTT..TTTTTTTTTT..TTTTTTTTTT.........................T
T........................................................................................................................................................................T
T........................................................................................................................................................................T
T.........................TTTTTTTTTT..TTTTTTTTTT..TTTTTTTTTT..TTTTTTTTTT..TTTTTTTTTT..TTTTTTTTTT..TTTTTTTTTT..TTTTTTTTTT..TTTTTTTTTT..TTTTTTTTTT.........................T
T.........................TTTTTTTTTT..TTTTTTTTTT..TTTTTTTTTT..TTTTTTTTTT..TTTTTTTTTT..TTTTTTTTTT..TTTTTTTTTT..TTTTTTTTTT..TTTTTTTTTT..TTTTTTTTTT.........................T
T........................................................................................................................................................................T
T........................................................................................................................................................................T
T.........................TTTTTTTTTT..TTTTTTTTTT..TTTTTTTTTT..TTTTTTTTTT..TTTTTTTTTT..TTTTTTTTTT..TTTTTTTTTT..TTTTTTTTTT..TTTTTTTTTT..TTTTTTTTTT.........................T
T.........................TTTTTTTTTT..TTTTTTTTTT..TTTTTTTTTT..TTTTTTTTTT..TTTTTTTTTT..TTTTTTTTTT..TTTTTTTTTT..TTTTTTTTTT..TTTTTTTTTT..TTTTTTTTTT.........................T
T........................................................................................................................................................................T
T........................................................................................................................................................................T
T.........................TTTTTTTTTT..TTTTTTTTTT..TTTTTTTTTT..TTTTTTTTTT..TTTTTTTTTT..TTTTTTTTTT..TTTTTTTTTT..TTTTTTTTTT..TTTTTTTTTT..TTTTTTTTTT.........................T
T.........................TTTTTTTTTT..TTTTTTTTTT..TTTTTTTTTT..TTTTTTTTTT..TTTTTTTTTT..TTTTTTTTTT..TTTTTTTTTT..TTTTTTTTTT..TTTTTTTTTT..TTTTTTTTTT.........................T
T........................................................................................................................................................................T
T........................................................................................................................................................................T
T.........................TTTTTTTTTT..TTTTTTTTTT..TTTTTTTTTT..TTTTTTTTTT..TTTTTTTTTT..TTTTTTTTTT..TTTTTTTTTT..TTTTTTTTTT..TTTTTTTTTT..TTTTTTTTTT.........................T
T.........................TTTTTTTTTT..TTTTTTTTTT..TTTTTTTTTT..TTTTTTTTTT..TTTTTTTTTT..TTTTTTTTTT..TTTTTTTTTT..TTTTTTTTTT..TTTTTTTTTT..TTTTTTTTTT.........................T
T........................................................................................................................................................................T
T........................................................................................................................................................................T
T.........................TTTTTTTTTT..TTTTTTTTTT..TTTTTTTTTT..TTTTTTTTTT..TTTTTTTTTT..TTTTTTTTTT..TTTTTTTTTT..TTTTTTTTTT..TTTTTTTTTT..TTTTTTTTTT.........................T
T.........................TTTTTTTTTT..TTTTTTTTTT..TTTTTTTTTT..TTTTTTTTTT..TTTTTTTTTT..TTTTTTTTTT..TTTTTTTTTT..TTTTTTTTTT..TTTTTTTTTT..TTTTTTTTTT.........................T
T........................................................................................................................................................................T
T........................................................................................................................................................................T
T.........................TTTTTTTTTT..TTTTTTTTTT..TTTTTTTTTT..TTTTTTTTTT..TTTTTTTTTT..TTTTTTTTTT..TTTTTTTTTT..TTTTTTTTTT..TTTTTTTTTT..TTTTTTTTTT.........................T
T.........................TTTTTTTTTT..TTTTTTTTTT..TTTTTTTTTT..TTTTTTTTTT..TTTTTTTTTT..TTTTTTTTTT..TTTTTTTTTT..TTTTTTTTTT..TTTTTTTTTT..TTTTTTTTTT.........................T
T........................................................................................................................................................................T
T........................................................................................................................................................................T
T.........................TTTTTTTTTT..TTTTTTTTTT..TTTTTTTTTT..TTTTTTTTTT..TTTTTTTTTT..TTTTTTTTTT..TTTTTTTTTT..TTTTTTTTTT..TTTTTTTTTT..TTTTTTTTTT.........................T
T.........................TTTTTTTTTT..TTTTTTTTTT..TTTTTTTTTT..TTTTTTTTTT..TTTTTTTTTT..TTTTTTTTTT..TTTTTTTTTT..TTTTTTTTTT..TTTTTTTTTT..TTTTTTTTTT.........................T
T........................................................................................................................................................................T
T........................................................................................................................................................................T
TTTTTTTTTTTTTTTTTTTTTTTTTTTTTTTTTTTTTTTTTTTTTTTTTTTTTTTTTTTTTTTTTTTTTTTTTTTTTTTTTTTTTTTTTTTTTTTTTTTTTTTTTTTTTTTTTTTTTTTTTTTTTTTTTTTTTTTTTTTTTTTTTTTTTTTTTTTTTTTTTTTTTTTTTT
