type octile
height 53
width 54
map
@@@@@@@@@@@@@@@@@@@@@@@@@@@@@@@@@@@@@@@@@@@@@@@@@@@@@@
@@@@@@@@@@@@@@@@@@@@@@@@@@@@@@@@@@@@@@@@@@@@@@@@@@@@@@
@@@@@@@@@@@@@@@@@@@@@@@@@@@@@@@@@@@@@@@@@@@@@@@@@@@@@@
@@@@@@@@@@@@@@@@@@@@@@@@@@@@@@@@@@@@@@@@@@@@@@@@@@@@@@
@@@@@@@@@@@TTTTTTTTTTTTT@@@TTTTTTTTTTTTTT@@@@@@@@@@@@@
@@@@@@@@@@T.............T@T..............T@@@@@@@@@@@@
@@@@@@@@@@T.............T@T..TTTT.T.....T@@@@@@@@@@@@@
@@@@@TTTTTT.............T@T.T@@@@T@T....TTTTTT@@@@@@@@
@@@@T.....T.............T@T.T@@@@@TT..........T@@@@@@@
@@@@T...................T@@T@@@@@T............T@@@@@@@
@@@TT...................T@@@T@@@@T............T@@@@@@@
@@T.....................T@@T.TTTT.............T@@@@@@@
@@@TT...................T@T....................@@@@@@@
@@@@T...................TT.....................@@@@@@@
@@@TT.........................................@@@@@@@@
@@T...........................................@@@@@@@@
@@T.....................................TTTTTT@@@@@@@@
@@T.....................TTT.............T@@@@@@@@@@@@@
@@@TTTTTTTTTTTTTTTT.....T@T.............T@@@@@@@@@@@@@
@@@@@@@@@@@@@@@@@@T.....T@@TT...........T@@@@@@@@@@@@@
@@@@@@@@@@@@@@@@@@T.....T@@@T...........TTTTT@@@@@@@@@
@@@@@@@@@@@@@@@@@@T.....T@@@T................T@@@@@@@@
@@@@@@@@@@@@@@@@@@T.....T@@@T...............T@@@@@@@@@
@@@@@@@@@@@@@@@@@@T.....T@@@T...............TT@@@@@@@@
@@@@@@@@@@@@@@@@@@T.....T@@@T.................@@@@@@@@
@@@@@@@@@@@@@@@@@@T.....T@@@T.............TTT.@@@@@@@@
@@@@@@@@@@@@@@@@@@T.....T@@TT.............T@@...T@@@@@
@@@@@@@@@@@@@@@@@@T.....T@T..............T@@T...T@@@@@
@@@@@@@@@@@@TTTT@@T.....T@T.............T@@@@T..T@@@@@
@@@@@@@@@@@T....TT......T@T.............T@@@@@T.T@@@@@
@@@@@@@@@@T..TT.........T@T.............T@@@@T..T@@@@@
@@@@@@@@@@T..TT.........T@T.............T@@@@T..T@@@@@
@@@@@@@@@@@TTTT.........T@T.....TTT......T@@TT..T@@@@@
@@@@@@@@@@@@T...TTT.....T@T.....T@T......TTT....T@@@@@
@@@@@@@@@@@@@TTT@@T.....T@T.....T@T.............T@@@@@
@@@@@@@@@@@@@@@@@@@TTT..T@T.....T@T.....TTT.....T@@@@@
@@@@@@@@@@@@@@@@@@@@@T..T@T.....T@T.....T@T.....T@@@@@
@@@@@@@@@@@@@@@@@@@@@T..T@T.....T@T.....T@T.....T@@@@@
@@@@@@@@@@@@@@@@@@@@T...T@T.....T@T.....T@@TTTTT@@@@@@
@@@@@@@@@@@@@@@@@@@@@TTT@@@TTTTT@@T.....T@@@@@@@@@@@@@
@@@@@@@@@@@@@@@@@@@@@@@@@@@@@@@@@@T.....T@@@@@@@@@@@@@
@@@@@@@@@@@@@@@@@@@@@@@@@@@@@@@@@@T.....T@@@@@@@@@@@@@
@@@@@@@@@@@@@@@@@@@@@@@@@@@@@@@@@@@TTTTT@@@@@@@@@@@@@@
@@@@@@@@@@@@@@@@@@@@@@@@@@@@@@@@@@@@@@@@@@@@@@@@@@@@@@
@@@@@@@@@@@@@@@@@@@@@@@@@@@@@@@@@@@@@@@@@@@@@@@@@@@@@@
@@@@@@@@@@@@@@@@@@@@@@@@@@@@@@@@@@@@@@@@@@@@@@@@@@@@@@
@@@@@@@@@@@@@@@@@@@@@@@@@@@@@@@@@@@@@@@@@@@@@@@@@@@@@@
@@@@@@@@@@@@@@@@@@@@@@@@@@@@@@@@@@@@@@@@@@@@@@@@@@@@@@
@@@@@@@@@@@@@@@@@@@@@@@@@@@@@@@@@@@@@@@@@@@@@@@@@@@@@@
@@@@@@@@@@@@@@@@@@@@@@@@@@@@@@@@@@@@@@@@@@@@@@@@@@@@@@
@@@@@@@@@@@@@@@@@@@@@@@@@@@@@@@@@@@@@@@@@@@@@@@@@@@@@@
@@@@@@@@@@@@@@@@@@@@@@@@@@@@@@@@@@@@@@@@@@@@@@@@@@@@@@
@@@@@@@@@@@@@@@@@@@@@@@@@@@@@@@@@@@@@@@@@@@@@@@@@@@@@@
