snake20x13
....................
....................
....................
...........E........
..........a>........
..........bG........
.........GF.FG......
.........F.G.F......
........GGF.FGG.....
........GG.G.GG.....
........GG.F.GG.....
........GG...GG.....
........GG...GG.....
