snake20x16
......GGGG..........
.......GGGG.........
.......GFG..F.......
.......GFG..........
.....1..............
.....<a.............
....b><c............
....GGGGS...........
....GGG.............
.....GGG.......E....
......G.............
.....G.......S......
.............G......
.............G......
.............G......
.............G......





