snake20x14
....................
....................
....................
....................
....................
....................
....................
......E.......<ab...
.............<cd....
....GGGGG...GGGGG...
.....GGG.....GGG....
....................
....................
....................