snake20x15
....................
....................
....................
.........E..........
....................
....................
....................
....................
.....ba>............
......GG...11.......
......GG.F.11.......
......GG...GG.......
......GGGGGGG.......
......GGGGGGG.......
.......GGGGG........