snake20x15
....................
..........E.........
....................
....................
..........11........
..........22........
..........33........
..........44........
..........55........
..........66........
.......a>.77........
......GGGGGGGGG.....
......GGGGGGGGG.....
........G...G.......
........G...G.......