snake20x12
....................
....................
............<a......
...........GGGG.....
...........GGGG.....
............GG......
....................
......E.............
.........F...F......
.....GGG...GGGG.....
.....GGG....GGG.....
.....GGG....GGG.....