snake15x15
...............
...............
...............
...............
...............
...........E...
...............
......S...GGG..
.....GGG..GGG..
..........GGG..
..GG...........
..G....S..<a...
..G..GGGGGGb...
..G..GGGG.Gc...
..G..GGGG.G....