snake20x11
....................
....................
....................
.............E......
.......<a..1........
.......b>..11GGG....
......GGG..GGGGG....
.....GGGGGGGGGGG....
.....GGGGG.GGGGG....
......G.G...G.G.....
......G.G...G.G.....