snake20x15
....................
....................
....................
..........E.........
....................
....................
....................
..........S.........
........1...1.......
........2..S2.......
........3...3.......
.......<abSdc>......
......GGGGGGGGG.....
........GGGGG.......
.........GG.........
