snake19x20
....................
....................
....................
....................
....................
....................
....................
....................
....................
....................
.........E..........
....................
.......GFG..........
....................
.........<a.........
.......GGGG..F......
......GGGGGGGGG.....
.....GGGGG..GGGG....
.....GGGG...GGGG....