snake15x12
...............
...............
...............
...............
...............
............E..
..a>...........
edGGS..S..SGGG.
.cb>.......G.G.
..GGGGGGG..G.G.
..G.GGG.G..G.G.
..G.GGG.G..G.G.