snake20x15
....................
....................
....GGG.............
..GGGGGGG...........
..G.F.F.GG..........
.GGFGFGFGG.GGG......
.GFFFFFFFGGGGGG.....
GG.GFGFGF<ab.EG.....
GGFFFFFFFGGGGG......
GGGFGFGFGGGG........
..G.F.F.G...........
...GGGGGG...........
...GGGGGG...........
...GGG..............
....................
