snake20x16
....................
....................
....................
................E...
....................
....................
.........G..........
..........11........
.........22.........
.........G..........
.........dc.........
.........Gba>.......
........<efgh.......
.........G..........
.........G..........
.........G..........
