snake24x13
........................
........................
.....GGGG........GGG....
.....GGGG........GGG....
......GG................
....G.............E.....
....G...................
....G.ba>...S....GGG....
....Odc<ef.....SSS......
....GGGGGGSSO..S........
......GG...SSSGS........
........................
........................
