snake20x17
....................
....................
....................
....................
............E.......
....................
....................
........<ab.G.......
.........Gc.........
............G.......
.........Ged>.......
.........<fgG.......
.........G..........
............G.......
.........G..........
....................
....................
