snake26x17
..........................
..........................
..........................
..........................
..........................
..........................
..........................
........GG.....E..........
........GGGG..............
....G....GG...............
......G..G...F.G..........
...ba>...G.G...GG...F.....
GGGGGGGG...GG.......GG....
GGGGGGGGGGGGGGGGGGGGGG....
GGGGGGGGG.GGGGGGGGGGG.....
.GGGGGGGG..GGGGGGGGGG.....
.GGGGGGG...GGGGGGGGGG.....

