snake20x12
....................
....................
......E.............
....................
....ba>.............
.....GG.....G.......
.....GG.....GG......
......G.....GG......
.........FFF........
.....GG.....GG......
.....GG.....GG......
.....GG.....GG......