snake20x13
....................
....................
....................
.............GGG....
...........GGGGG....
..........GGGGGG....
..........GG..GGG...
.......E...G.FGGG...
......a>.....GGGG...
......GGGF..GGGGGG..
.....GGGGGGGGGGGGG..
.....GGGGGGGGGGGGG..
.....GGGGGGGGGGGGG..