snake20x15
....................
....................
....................
..........SS........
.......SSSGSS.......
......SGGGGGGS......
......GG..GGGG......
......GG.F.F.G......
.......GFGF.FG......
....E.a>.F..GG......
......bGGG.FGG......
......cdeGGGG.......
........f.GG........
........g...........
....................
