snake15x12
...............
...............
...............
...............
...ES..........
....SG.........
.....G.S.......
..........<ab..
......GS..<cde.
......G..GGGGG.
......G..G...G.
......G..G...G.