snake20x13
......GGGGGGGGGGGGGG
.......GG..GGGGGG...
.......G....GGGGG...
.......F....GGGG....
.......GG.F.GGGG....
.....F..G.G..GGG....
........F.G..GG.....
......F.G.F.GG.E....
........Ga>.GG......
.........bG.GGG.....
.........cG.........
..........G.........
..........G.........