snake20x15
....................
....................
....................
....................
....................
....................
....................
...a>...............
...GG.......eb>.....
...GGSS.....dc......
...GG.S....111......
...GG.S.....1..f>...
...GG.G..E.GGGGGGG..
...GG.G....GGGGGGG..
...GG.G....GGGGGGG..