snake20x15
............GGGGG...
............GGGGG...
............GGGGG...
.............GGG....
.............GGG....
.............GGG....
......G.............
......G.......E.....
......O.111.........
.........1...GGG....
.........<a..OGG....
.....GGGGGGG.GGG....
......GGGGG..GGG....
.......G.G...GGG....
....................