Snake12x22
......................
......................
..........E...........
......................
......G...............
......F..GFG..........
......................
.......Ga>............
.......GGGG...........
.......GGGG...........
.......GGG............
.......GGG............
