snake15x15
...............
...............
...............
...............
...............
......G........
......G........
..ba>..........
.GGGG....E.....
.GGGG..........
.G..G..SGGG....
.G..GSGSG.G....
.G..GGGGG.G....
.G..GG.GG.G....
.G..GG.GG.G....