snake20x18
....................
....................
....................
....................
..........E.........
....................
....................
.......G.1..........
.......GGG..S.......
.........FG.........
..........G.........
.......SG1..........
..........ba>.......
.........G<cd.......
........GGGGG.......
........GGGGG.......
........GGGGG.......
.........G.G........
.........G.G........
