snake20x16
....................
....................
....................
....................
.........E..........
....................
........G......O....
.............GGGGG..
.......G.....GGGGG..
.........G...GG.GG..
.............G...G..
..a>.O....G..G...G..
..bGGGG.............
....GG..............
....................
....................