snake20x15
....................
....................
.....GGG............
....GGGG.E..........
.......G............
.....F.G...cGG......
.........<abG.......
......GGGG.GG.......
.......GGG.G........
.........G.F........
.........G.GG.......
.........G.GG.......
........GG.GG.......
........GGGG........
........GGGG........
