snake19x16
...................
...................
..........GG.......
..........GG.......
..........GG.......
..........GG.......
...........G.......
....E......G.......
.......G.S...<ab...
.........G.G<dec...
......G..G.GGGG....
............GG.....
.......GGG.........
........GG.........
.........GGS.......
...................