snake20x14
....................
....................
...............GGG..
.............GGGGG..
.............GGGG...
..............GG....
......GG.........G..
......G..G.....E.GG.
.........GG......GG.
....ba>......GGGGGG.
..GGGGGGGGGGGGGGGGGG
.GGGGGGGGGGGGGGGGGGG
GGGGGGGGGGGGGGGGGGGG
GGGGGGGGGGGGGGGGGGGG