snake20x14
....................
....................
....................
....................
....................
........E...........
....................
......GGGGG.........
.....GGGGGGG........
.....G....G1........
.....G.a>.111..G....
.....GGGGGGGGGGG....
.......G..G..G......
.......G..G..G......