snake20x15
....................
....................
....................
....................
.............F......
............GGG.....
............GGG.....
............GGG.....
............GGG.....
....................
..........^b>E......
........c>a<d.......
.......GGGGGGGG.....
.........GGGG.......
....................