snake20x13
....................
....................
....................
....................
.......GGOGG........
.....E.GG.GG........
..........1.........
......G...a>........
.......O..<b........
.......GGGGG........
....................
....................
....................
