snake20x14
....................
..........GGGG......
.........GGGGGG.....
........GGG..GGG....
....................
..............E.....
..........a>........
..........<b.GGG....
..........12.GGG....
..........11..GG....
........GGGGGGGG....
........GGGGGGGG....
..........G..G......
..........G..G......