snake20x18
...........GGGGG....
............GGGG....
............GGGG....
....................
.............E......
....................
....................
...........GGGG.....
...........GGGG.....
............GGG.....
...........GGGG.....
.....ba>...GGGGG....
.....c11....GGGG....
.....d22...GGGGG....
....GGGG..GGGGGG....
....GGGGGG.GGGGG....
.....GGGG...G.G.....
.....GGG....G.G.....



