snake20x16
....GGGGG...........
.....GGG............
......G.............
....................
....................
.....GGG............
.....GGG.E..........
.....G.O............
.......GG...........
.....GGGG...........
.....GGG....O.......
.....GGG.....<ab....
.....GGG..GGGGGc....
.....GGG...GGG......
.....GGG....G.......
.....GGG............