snake20x16
....................
....................
....................
.........F..........
.........G..........
....................
....................
....................
....................
.......111.b........
.......111<aE.......
........1.<c........
........GGGd........
........GGG.........
.........G..........
.........G..........

