snake20x12
....................
....................
............GG......
...........GGG......
.....GGG...GG.......
....GGGGGF..........
....G..GG...........
....G.......E.......
....GGG.F..<ab......
.....GG...GGGG......
......G....GGGG.....
......G....GGGG.....