snake20x13
....................
....................
........GG..........
........GGG.........
........GGG..E......
.........G..........
........<ab.........
......S.dc>.S.......
........1F1.........
........111..G......
........GSG..G......
........GGG..G......
........GGG..G......
