snake20x14
....................
....................
....................
....................
....................
....................
....................
.........ba>........
..........GG........
......E...c>........
.....GGGGGGG..GG....
..............GG....
..............G.....
..............G.....