snake20x15
....................
....................
....................
....................
.........E..........
....................
........GGGO........
.........G..GG......
....................
....................
...........<ab......
.......GGOGGGGG.....
.......GGGGGGGG.....
..........GG........
....................