snake20x20
....................
....................
..........E.........
....................
..........G.........
..........G.........
....................
...........GG.......
...........GG.......
.......F............
......GG..G.........
.......G............
..........G.........
..........GF........
.........GGG........
....................
........GGba>.......
........GGGGGG......
........GGGGGGG.....
........GGGGGGG.....