snake20x15
....................
....................
....................
....................
....................
....................
..........<a........
..........b>........
.....GGSFSGGG.......
....................
....................
......E.............
......GGSG.G.G......
......GG.G.G.G......
......GG.G.G.G......