snake20x12
....................
....................
....................
....................
....................
....................
......E.^...........
.......ba...<c......
.....GGGGGFGGGGG....
.........GGG........
....................
....................