snake20x14
....................
....................
....................
....................
....................
....................
......E.............
..............<a....
.....GGG.....GGG....
.....GGG..<bcGGG....
......GGGGGGGGG.....
....................
....................
....................