snake20x15
....................
....................
....................
....................
....................
......GGG...........
......GGG...........
.......<a....E......
.......GG...........
.......G....GGG.....
........<a...GG.....
......GGGb..GGG.....
......GGGc..GGG.....
......GGG...GGG.....
......GGG...GGG.....