snake15x14
...............
...............
...............
...............
...........E...
...............
..........GGG..
..........GGG..
....111...G.G..
.....1S...G.G..
..a>..S...G.G..
..bGGGG...G.G..
..cG..G...G.G..
...G..G...G.G..
...G..G...G.G..