snake20x15
....................
....................
....................
.........G..........
.........GFG........
.....E.....G........
.............G.G....
....GGG.F....G......
....G...G....GGG....
....G.G.GG..........
....a>............G.
...GGG......F...GGG.
...GGG.G.G.GGG..GGG.
...GGG.....GGG......
...GGG.....GGG......