snake15x15
...............
...............
...............
...............
...............
....E..........
...........<a..
...GGG.S.GGGb..
.....G...G.....
.....GGG.G.....
.......G.G.....
.......GGG.....
...............
...............
...............