snake20x22
....................
....................
.........E..........
....................
....................
....................
....................
....................
.........GS.........
....................
....................
........SS..........
......G.............
..........G.........
....................
....................
.....ba>..<d........
.....cGGGGGef.......
.....GGGG.GGg.......
....................
....................
