snake20x15
....................
....................
....................
....................
........O...........
............O.......
....a>.......<d.....
....bGGS.SGGGGGG....
....cGGS..GG..GGG...
......GS....E.GG....
......GS...GGGG.....
.......S.SGG........
.......S.S..........
......GGGG..........
......GGGG..........