snake20x14
....................
....................
....................
.........G..........
.........G..........
.........G..E.......
.........G..........
....a>...G..........
....cb>.............
....dGGG.G..G.......
.....GGG.G..G.......
.........G..G.......
.........G..G.......
.........G..G.......