snake20x13
....................
....................
....................
....S...............
.S..G...............
.G.E..........F.....
....<a..............
...cb>..............
...d<g..............
...eGh..............
...fGi..............
....Gj..............
....G...............
