snake20x16
....................
....................
....................
..........GG........
.........GGGG.......
.........GGGG.......
....E.....GG........
....................
...GGG....G.........
...GGG..............
....G...........F...
..........G.........
..cba>........GGGGG.
..GGGGG...G...GGGG..
..GGGG....G....GG...
...GGG....G....GG...