snake20x13
....................
....................
....................
....................
......O.............
........F...E.......
....SF..............
......S.............
.....a>.O...........
.....<b.............
....SGGGG..SG.......
.....GG.G...G.......
......G.G...G.......
