snake20x18
....................
....................
....................
....................
.............SSSSSSS
.............GGGGGGG
............1GGGGGGG
............222.GGGG
.....dcba>...GGGGGGG
.....eGGGGGG.GGGGGGG
.....fGGGGGG1GGGGGGG
.....g..GESG.....G..
.....h..G.SG..G..G..
.....i..G.S......G..
.....j..G.S......G..
........G.S.S....G..
........G...G....G..
....................