snake20x18
....................
....................
..........E.........
....................
..........G.........
......11............
......G.....G.......
......GG....G.......
............GG......
......22............
......GG............
......GG.333GG......
......GG.....G......
......<ab333........
......dc>GG<ef......
......GGGGGGGG......
......GGGGGGG.......
.........GGG........
