snake20x16
....................
...........G........
...........G........
...........G........
...........G........
.E........111..S....
..........1^1.......
..........1a1.......
...........b........
.........d>c...S....
.....G...egf>GSS....
....GG....SGSS......
....................
....GG..............
........G...........
....................
