type octile
height 34
width 50
map
@@@@@@@@@TTTTTTTT@@@@@@@@TTTTTTTTTTTTTTTTTTTTTTTT@
TTTT..TTTTTTTTTTTTTTTTTTTTTTTTTTTTTTTTTTTTTTTTTTTT
TTTT.............TTTTTTTTTT..............TTTTTTTTT
TTT...................TTTTT.....................TT
TTTT...................TTTT.TT..................TT
TTTT...................TTTT.TT..................TT
TTTT...................TTTT.....................TT
TTTT...................TTTT.....................TT
TTTT...................TTTTTTTTTTTT.............TT
TTTT...................TTTTTTTTTTTT...........TTTT
TTTT....................TTTTTT@@TT............TTTT
TTTT......................TTTT@@TT............TTTT
TT..........................TT@@TT............TTTT
TT..........................TT@@TT............TTTT
TT.....................TTTT.TT@@TTTTT.........TTTT
TT.....................TTTT.TT@@TTTTT.........TTTT
TT.....................TTTT.TT@@TTTTT...........TT
TTTT...................TTTT.TT@@TT.............TTT
TTTT...................TTTT.TT@@TTTT..........TTTT
TTTT...................TTTT.TT@@TTTT..........TTTT
TTTT...................TTTTTTT@@TTTT..........TTTT
TTTT...................TTTTTTT@@TTTT..........TTTT
TTTT...................TTTTTTT@@TTTT..........TTTT
TTTT...................TTTTTTT@@TTTT.........TTTTT
TT@T....................TTTTTT@@TT...........TTTTT
TTTT....................TTTTTTTTTTT..........TTTTT
TT......................TTTTTTTTTT...........TTTTT
TT......................TTT..................TTTTT
TTTT.........................................TTTTT
TTTT.........................................TTTTT
TTTTT........TTT.........TT..............TTT.TTTTT
TTTTTTTT.TTTTTTTT.......TTT..............TTT.TTTTT
TTTTTTTTTTTTTTTTTTTTTTTTTTTTTTTTTTTTTTTTTTTTTTTTTT
TTTTTTTTTTTTTTTTTTTTTTTTTTTTTTTTTTTTTTTTTTTTTTTTTT
