type octile
height 190
width 50
map
TTTTTTTTTTTTTTTT..TTTTTTTTTTTTTTTTTTTTTTTTTTTTTTT@
TTTTTTTTTTTTTTTT..TTTTTTTTTTTTTTTTTTTTTTTTTTTTTTT@
TTTTTTTT......................TTTTTTT...........T@
TTTTT.........................TTTTTTT...........T@
TTTTT.........................TTTTT.............T@
TT............................TTTTT....TTTTTT...T@
TT............................TTTTT....TTTTTTT..T@
TT............................TTTTT...TTTTTTTT..T@
TT............................TTTTT...TTTTTT....T@
TT..............................TTT....TTTTT....T@
TT.....................................TTTTT....T@
TT.....................................TTTTT....T@
TT.....................................TTTTT....T@
TTTT...................................TTTTT....T@
TTTT...................................TTTTTT...T@
TTTT...................................TTTTTT...T@
TTTT...................................TTTTT....T@
TTTT..................................TTTTTTT...T@
TTTT.................................TTTTTTTT...T@
TTTTT..........................TTT....TTTTTTT...T@
TTTTT..........................TTT.....TTTTT....T@
TTTTT.............TTTTTT.......TTT.....TTTTT....T@
@TTTT...........TTTTTTTT.TTTT..TTT...TTTTTTT....T@
@TTTTTTT..TTTTTTTTTTTTTTTTTTTTTTTT...TTTTTTT....T@
@TTTTTTT..TTTTTTTTTTTTTTTTTTTTTTTT....TTTTTT....T@
@TTTTTTT..TTTTTTTTTTTTTTTTTTTTTTTT....TTTTTT....T@
@TTTT..........................TTT....TTTTTT....T@
@T.............................TTTT....TTT......T@
@T.............................TTTTTT..TTT......T@
@TTT...........................TTTTTTT.........TT@
@TTT...........................TTTTTT........TTTT@
@TTTTTTT..TTTT......TTTT..TTTTTTTTTTTTTTTTTTTTTTT@
@TTTTTTT..TTTTTTTTTTTTTT..TTTTTTTTTTTTTTTTTTTTTTT@
@TTTTTTT..TTTTTTTTTTTTTT..TTTTTTTTTTTTTTTTTTTTTTT@
TTTTTTTT..TTT.TTTT....................TTTTTTTT@@T@
TTTTT.........TTTT....................TTTTTTTT@@T@
TTTTT........TTTTT....................TTTTTTTT@@T@
TTTTT........TTTTT....................TTTTTTTT@@T@
TT...........TTTTT...................TTTTTTTTTTTT@
TT...........TTTTT...................TTTTTTTTTTTT@
TT...........TTTTT.TTTTT.....................TT.T@
TT...........TTTTT.TTTTT........................T@
TT...........TTTTT.TTTTT.......................TT@
TT...........TTTTT.TTTTT......................TTT@
TTTT...........TTT.TTTTT......................TTT@
TTTT..........TTTT.TTTTT........................T@
TTTT......TTTTTTTT.TTTTT.....................TTTT@
TTTT......TTTTTTTT.TTTTT.....................TTTT@
TTTTTT....TTTTTTTT...TTTTTTTT...............TTTTT@
@TTTTTTT..TTTTTTTT...TTTTTTTT...............TTTTT@
@TTTTTTTTTTTTTTTTTTTTTTTTTTTTTTTTTTTTT......TTTTT@
@T@TTTT@TTTTTTTTTTTTTTTTTTTTTT@@@@TTTT......TTTTT@
@TTTTTTTTTTTTTTTTTTTTTTTTTTTTTTTTTTTTTTT..TTTTTTT@
@@@@@@@@@@@@@@@@@@@@@@@@@@@@@@@@@@@@@TTT..TTT@@@@@
@@@@@@@@@@@@@@@@@@@@@@@@@@@@@@@@@@@@@@TT..TT@@@@@@
@@@@@@@@@@@@@@@@@@@@@@@@@@@@@@@@@@@@@@......@@@@@@
@@@@@@@@@@@@@@@@@@@@@@@@@@@@@@@@@@@@@@......@@@@@@
@@@@@@@@@@@@@@@@@@@@@@@@@@@@@@@@@@@@@@......@@@@@@
@@@@@@@@@@@@@@@@@@@@@@@@@@@@@@@@@@@@@@......@@@@@@
@@@@@@@@@@@@@@@@@@@@@@@@@@@@@@@@@@@@@@......@@@@@@
@@@@@@@@@@@@@@@@@@@@@@@@@@@@@@@@@@@@@@......@@@@@@
@@@@@@@@@@@@@@@@@@@@@@@@@@@@@@@@@@@@@T......T@@@@@
@@@@@@@@@@@@@@@@@@@@@@@@@@@@@@@@@@@@@@......@@@@@@
@@@@@@@@@@@@@@@@@@@@@@@@@@@@@@@@@@@@@@......@@@@@@
@@@@@@@@@@@@@@@@@@@@@@@@@@@@@@@@@@@@@@......@@@@@@
@@@@@@@@@@@@@@@@@@@@@@@@@@@@@@@@@@@@@@......@@@@@@
@@@@@@@@@@@@@@@@@@@@@@@@@@@@@@@@@@@@@@......@@@@@@
@@@@@@@@@@@@@@@@@@@@@@@@@@@@@@@@@@@@@@......@@@@@@
@@@@@@@@@@@@@@@@@@@@@@@@@@@@@@@@@@@@@T......T@@@@@
@@@@@@@@@@@@@@@@@@@@@@@@@@@@@@@@@@@@TT......TT@@@@
@@@@@@@@@@@@@@@@@@@@@@@@@@@@@@@@@@@@TT......TT@@@@
@@@@@@@@@@@@@@@@@@@@@@@@@@@@@@@@@@@@TT......TT@@@@
@@@@@@@@@@@@@@@@@@@@@@@@@@@@@@@@@@@@TT......TT@@@@
@@@@@@@@@@@@@@@@@@@@@@@@@@@@@@@@@@@@TT......TT@@@@
@@@@@@@@@@@@@@@@@@@@@@@@@@@@@@@@@@@@TT......TT@@@@
@@@@@@@@@@@@@@@@@@@@@@@@@@@@@@@@@@@@TT......TT@@@@
@@@@@@@@@@@@@@@@@@@@@@@@@@@@@@@@@@@@TT......TT@@@@
@@@@@@@@@@@@@@@@@@@@@@@@@@@@@@@@@@@@TT......TT@@@@
@@@@@@@@@@@@@@@@@@@@@@@@@@@@@@@@@@@@TT......TT@@@@
@@@@@@@@@@@@@@@@@@@@@@@@@@@@@@@@@@@@TT......TT@@@@
@@@@@@@@@@@@@@@@@@@@@@@@@@@@@@@@@@@@TT......TT@@@@
@@@@@@@@@@@@@@@@@@@@@@@@@@@@@@@@@@@@TT......TT@@@@
@@@@@@@@@@@@@@@@@@@@@@@@@@@@@@@@@@@@TT......TT@@@@
@@@@@@@@@@@@@@@@@@@@@@@@@@@@@@@@@@@@TT......TT@@@@
@@@@@@@@@@@@@@@@@@@@@@@@@@@@@@@@@@@@TT......TT@@@@
@@@@@@@@@@@@@@@@@@@@@@@@@@@@@@@@@@@@TT......TT@@@@
@@@@@@@@@@@@@@@@@@@@@@@@@@@@@@@@@@@@TT......TT@@@@
@@@@@@@@@@@@@@@@@@@@@@@@@@@@@@@@@@@@TT......TT@@@@
@@@@@@@@@@@@@@@@@@@@@@@@@@@@@@@@@@@@TT......TT@@@@
@@@@@@@@@@@@@@@@@@@@@@@@@@@@@@@@@@@@TT......TT@@@@
@@@@@@@@@@@@@@@@@@@@@@@@@@@@@@@@@@@@TT......TT@@@@
@@@@@@@@@@@@@@@@@@@@@@@@@@@@@@@@@@@@TT......TT@@@@
@@@@@@@@@@@@@@@@@@@@@@@@@@@@@@@@@@@@TT......TT@@@@
@@@@@@@@@@@@@@@@@@@@@@@@@@@@@@@@@@@@TT....TTTT@@@@
@@@@@@@@@@@@@@@@@@@@@@@@@@@@@@@@@@@@TT....TTTT@@@@
@@@@@@@@@@@@@@@@@@@@@@@@@@@@@@@@@@@@TT....TTTT@@@@
@@@@@@@@@@@@@@@@@@@@@@@@@@@@@@@@@@@@TT......TT@@@@
@@@@@@@@@@@@@@@@@@@@@@@@@@@@@@@@@@@@TT......TT@@@@
@@@@@@@@@@@@@@@@@@@@@@@@@@@@@@@@@@@@TT......TT@@@@
@@@@@@@@@@@@@@@@@@@@@@@@@@@@@@@@@@@@TT......TT@@@@
@@@@@@@@@@@@@@@@@@@@@@@@@@@@@@@@@@@@TT......TT@@@@
@@@@@@@@@@@@@@@@@@@@@@@@@@@@@@@@@@@@TT......TT@@@@
@@@@@@@@@@@@@@@@@@@@@@@@@@@@@@@@@@@@TT......TT@@@@
@@@@@@@@@@@@@@@@@@@@@@@@@@@@@@@@@@@@TT......TT@@@@
@@@@@@@@@@@@@@@@@@@@@@@@@@@@@@@@@@@@TT......TT@@@@
@@@@@@@@@@@@@@@@@@@@@@@@@@@@@@@@@@@@TT......TT@@@@
@@@@@@@@@@@@@@@@@@@@@@@@@@@@@@@@@@@@TT......TT@@@@
@@@@@@@@@@@@@@@@@@@@@@@@@@@@@@@@@@@@TTTT..TTTT@@@@
@TTTTTTTTTTTTTTTTTTTTTTTTTTTTTTTTTTTTTTT..TTTTTTT@
@TTTTTTTTTTTTTTTTTTTTTTTTTTTTTTTTTTTTTTT..TTTTTTT@
@T...TTTTTT......TTTTTTT.TTT@TTTTTTTT.......TTTTT@
@T...TTTTTT......TTTTTTT.TTTTTTTTTTTT........TTTT@
@T...TTTTTT......TTTTTT..TTTT....TTTT........TTTT@
@T...TTTT........TTTT....TTTT....TTTT.........TTT@
@T...TTTT........TTT.....TTTT....TTTT.........TTT@
@TT.............................................T@
@TTT............................................T@
@TTT............................................T@
@TTT............................................T@
@TTT............................................T@
@TTT............................................T@
@T..............................................T@
@T..............................................T@
@T..............................................T@
@TTTTTT.........................................T@
@TTTTTT.........................................T@
@TTTTTT....................................TTTTTT@
@TTTTTT....................................TTTTTT@
@TTTTTT...................TTTTTT............TTTTT@
@TTTTTT........TTTTTT.....TTTTTT...........TTTTTT@
@TTTTTT.....TTTTTTTTT....TTTTTTT...........TTTTTT@
@TTTTTT....TTTTTTTTTT....TTTTTTTTTT........TTTT@T@
@TTTTTTT..TTTTTTTTTTTTTTTTTTTTTTTTTTTTTT..TTTTTTT@
@TTTTTTT..TTTTTTTTTTTTTTTTTTTTTTTTTTTTTT..TTTTTTT@
TTTTTTTT..TTTTTTTTTTTTTTTTTTTTTTTTTTTTTT..TTTTTTT@
TTT..................TTTT.TTTTTTTTT..........TTTT@
TT.............TTTTTTT....TTTTTTTTT..........TTTT@
TT........................TTTTTTTTT..........TTTT@
TT........................TTTTTTTTT..........TTTT@
TT........................TTTTTTTTT.............T@
TT..............................................T@
TT..............................................T@
TT..............................................T@
TT..............................................T@
TT..............................................T@
TT..............................................T@
TT..............................................T@
TT..............................................T@
TTT...TTTTTTTTTTTTTTTTTTTTTTTTTTTTTTTTTTTTTT..TTT@
TTT...TTTTTTTTTTTTTTTTTTTTTTTTTTTTTTTTTTTTTT..TTT@
TTT...TT.TTTTTTTT..TTT.......T@@@@T@@@@@@@T...TTT@
TTT...TT.TTTTTTTT..TTT.......TTTTTTT@@@@@@T...TTT@
TTT...TT.TTTTTTTT...TT.............TTTTTTTT...TTTT
TTT...TT.TTTTTTTT..................TTTTTTTT...TTTT
TTT...TT.TTTTTTTT.........................T...TTTT
TTT...TT..................................T...TTTT
TTT...TT..................................T...TTTT
TTT...TT..................................T...TTTT
TT..............................................TT
TT..............................................TT
TT..............................................TT
TT..............................................T@
TT..............................................T@
TT..............................................T@
TT..............................................T@
TT..............................................T@
TT..............................................T@
TT..............................................T@
TT..............................................T@
TT..............................................T@
TT..............................................T@
TT..............................................T@
TT..............................................T@
TT..............................................T@
TT..............................................T@
TT..............................................T@
TT..............................................T@
TTTTTT..........................................T@
TTTTTT..........................................T@
TTTTTT..........TTT.............................T@
TTTTTT.....TT..TTTTTT...........................T@
TTTTTT....TTT..TTTTTTTT.........................T@
TT@@TTTTTTTTT..TTTTTTTTT.......................TT@
TT@@TTTTTTTT..TTTTTTTTT......................TTTT@
TT@@TTTTTTTT....TTTTTTT....................TTTTTT@
TT@@TTTTTTTT......TTTT.....................TTTTTT@
TT@@TTTTTTTT........TT.TT............TTTT..TTTTTT@
TT@@@@TTTTTT...........TTT...........TTTTT..TTTTT@
TTTTTTTTTTTTTTTTTTTTTTTTTTTTTTTT..TTTTTTTTTTTTTTT@
@T@@TTTTTT@@@@@@@@@@@@@@@@@@@@@@@@@@@@@@@@@@@@@@@@
