type octile
height 50
width 34
map
@@TTTTTTTTTTTTTTTT@@@@@@@@@@@@@@@@
@@TTT@@T@TTTTTTTTT@@@@@@@@@@@@@@@@
@@T@TTTTTTTTTTT@TT@@@@@@@@@@@@@@@@
@@T@TTTTTTTTTTT@TT@@@@@@@@@@@@@@@@
@@T@TTTTTTTTTTTT@T@@@@@@@@@@@@@@@@
@@TTTTTTTTTTTTTTTT@@@@@@@@@@@@@@@@
@@T.TTTTTTTTTTTTTT@@@@@@@@@@@@@@@@
@@..TTTTTTTTTTTTTT@@@@@@@@@@@@@@@@
@@....TTTTTTTTTTTT@@@@@@@@@@@@@@@@
@@T.......TTTTTTTT@@@@@@@@@@@@@@@@
@@T........TTTTTTT@@@@@@@@@@@@@@@@
@@T........TTTTT.T@@@@@@@@@@@@@@@@
@@T.........TT...T@@@@@@@@@@@@@@@@
@@T.............TT@@@@@@@@@@@@@@@@
@@TT............TT@@@@@@@@@@@@@@@@
@@TTT.........TTTT@@@@@@@@@@@@@@@@
@@TTT.........TTTT@@@@@@@@@@@@@@@@
@@TTT.........TTTT@@@@@@@@@@@@@@@@
@@...............T@@@@@@@@@@@@@@@@
@@..............TT@@@@@@@@@@@@@@@@
@@..............TT@@@@@@@@@@@@@@@@
@@.............TTT@@@@@@@@@@@@@@@@
@@.............TTT@@@@@@@@@@@@@@@@
@@.............TTT@@@@@@@@@@@@@@@@
@@TT..........TTTT@@@@@@@@@@@@@@@@
@@TTT.........TTTT@@@@@@@@@@@@@@@@
@@@TTT.........TTT@@@@@@@@@@@@@@@@
@@@@@TT..........T@@@@@@@@@@@@@@@@
@@@@@@TT.........T@@@@@@@@@@@@@@@@
@@@@@@@TT........T@@@@@@@@@@@@@@@@
@@TT@@TTT.......TT@@@@@@@@@@@@@@@@
@@TT@TTT........TT@@@@@@@@@@@@@@@@
@TTTTT..........TTTTTTTTTTTTTTTTTT
TTTT............TTTT...TTTTT@@@@TT
TTT.........@..........TTTTTTTTT@T
TTTT..................TTTTTTTTTTTT
@TTT..................TTTTTTTTTTTT
@TTT..................TTTTTTTTTTTT
@TTT.................TTTTTTTTTTTTT
@TTTT...................TTTTTTTTTT
TTTTT...................TT@TTTTT@T
TTTTTT...................TT@@TTT@T
TTTT@T...................TTTTTTTTT
TTT@TT......................TTTTTT
TT@TT............................T
TT@TT.....T......................T
TTT......TTTTTT.TTTT............TT
TTTT....TTTTTTTTTTTT...T...T....TT
TTTTTTTTTTTTTTTTTT@@@@@@@@@@@@@@@@
TTTTTTTTTTTT@TTTTT@@@@@@@@@@@@@@@@
