type octile
height 113
width 259
map
TTTT@@@@@@@@@TTTTTTTTTTTTTTT@@@@@@@@TTTTTTTT@@@@@@@@@@TTTT@@@@@@@@@@@@TTTT@@@@@@@@@@TTTT@@@@@@@@@@@@@@@@@@@@@@@@@@@@@@@@@@@@@@@@@@@@@@@@@@@@@@@@@@@@@@@@@@@@@@@@@@@@@@@@@@TTTT@@@@@@@@TTTT@@@@@@@@@TTT@@@@@@@@TTTTTTT@@@@@@@@@@@@@@@@@@@@@@@@@@@@@@@@@@@@TTT@@@@TT@
TTTTTTTTTTTTTTTTTTTTTTTTTTTTTTTTTTTTTTTTTTTTTTTTTTTTTTTTTTTTTTTTTTTTTTTTTTTTTTTTTTTTTTTTT@@@@@@@@@@@@@@@@@@@@@@@@@@@@@@@@@@@@@@@@@@@@@@@@@@@@@@@@@@@@@@@@@@@@@@@@@@@@@@@@@TTTTTTTTTTTTTTTTTTTTTTTTTTTTTTTTTTTTTTTTTTTTTTTTTTTTTTTTTTTTTTTTTTTTTTTTTTTTTTTTTTTTTTTTT
TTTT@@TTTTTTTTTTT.TTTTT@TTTTTTTTTTTTTTTTTTTTTTTTTTTTTTTTTTTTTT.TTTTTTTTTTTTTT.TTTTTTTTTT@@@@@@@@@@@@@@@@@@@@@@@@@@@@@@@@@@@@@@@@@@@@@@@@@@@@@@@@@@@@@@@@@@@@@@@@@@@@@@@@@@TTTT.TTTTTT.TTTT.T.......TTTTTTTTTTTTTTTTTTTTTTTTTTTTTTTTTTTTTT...TTTTTT.....TTTTTTTTTTT@
TTTTTTTTTTTTTTTTT.TTTTT@TTTTTTTTTTTTTTTTTTTTTTTTTTTTTTTTTTTTTT.TTTTTTTTTTTTTT.TTTTTTTTTT@@@@@@@@@@@@@@@@@@@@@@@@@@@@@@@@@@@@@@@@@@@@@@@@@@@@@@@@@@@@@@@@@@@@@@@@@@@@@@@@@@TTTT.TTTTTT.TTTT........TTTTTT....TTT@TTTTTTTTTTTTTTTTTTTTTTTTT...TTTTTT.....TTT.TTTTTTT@
TTTTTTTTTTTTTTTTT.TTTTTTTTTT........TTTTTT..TT......TT.....TT......TT.....TT......TT..TT@@@@@@@@@@@@@@@@@@@@@@@@@@@@@@@@@@@@@@@@@@@@@@@@@@@@@@@@@@@@@@@@@@@@@@@@@@@@@@@@@@TTTT.TTTTTT.TTTT........TTTT......TTTTTTTTT.......TT........TTT...TTT...............TTTT@
TTTTTT.............TTTTT............TTTTTT............................................TT@@@@@@@@@@@@@@@@@@@@@@@@@@@@@@@@@@@@@@@@@@@@@@@@@@@@@@@@@@@@@@@@@@@@@@@@@@@@@@@@@@TTT..TTTTTT..TTT........TTTT......TTTTTTTT.........................TT...............TTTT@
TTTTTT.............TTTTT............TTTTTTTTT.........................................TT@@@@@@@@@@@@@@@@@@@@@@@@@@@@@@@@@@@@@@@@@@@@@@@@@@@@@@@@@@@@@@@@@@@@@@@@@@@@@@@@@@TT.................................TTTTTTTTT........................................TTTT@
TTTTTT.............TT...............TTTTTTTTT.........................................TT@@@@@@@@@@@@@@@@@@@@@@@@@@@@@@@@@@@@@@@@@@@@@@@@@@@@@@@@@@@@@@@@@@@@@@@@@@@@@@@@@@TT..................TT............TTTTTTTTTT....................................TTTTTTTT@
TTTTTT..............................TTTTTTTTT.........................................TT@@@@@@@@@@@@@@@@@@@@@@@@@@@@@@@@@@@@@@@@@@@@@@@@@@@@@@@@@@@@@@@@@@@@@@@@@@@@@@@@@@TT................TTTTT...........TTTTTTTTTT....................................TTTTTTTT@
TTTTTT..............................TTTTTTTTT.........................................TT@@@@@@@@@@@@@@@@@@@@@@@@@@@@@@@@@@@@@@@@@@@@@@@@@@@@@@@@@@@@@@@@@@@@@@@@@@@@@@@@@@@T................TTTTT...........TTTTTTTTTT........................................TTTT@
TTTTTT..............................TTTTTTTTT.........................................TT@@@@@@@@@@@@@@@@@@@@@@@@@@@@@@@@@@@@@@@@@@@@@@@@@@@@@@@@@@@@@@@@@@@@@@@@@@@@@@@@@@@T............TTTTTTTTTTTTT.........TTTTTT...........................................TTT@
TTTTTT..............................TTTTTTTTT.........................................TT@@@@@@@@@@@@@@@@@@@@@@@@@@@@@@@@@@@@@@@@@@@@@@@@@@@@@@@@@@@@@@@@@@@@@@@@@@@@@@@@@@@T............TTTTTTTTTTTTT.........TTTTTT............................................TT@
TTTTT...............................TTTTTTTTT.........................................TT@@@@@@@@@@@@@@@@@@@@@@@@@@@@@@@@@@@@@@@@@@@@@@@@@@@@@@@@@@@@@@@@@@@@@@@@@@@@@@@@@@@T................TTTTT.............TTTTTTTT..........................................TT@
TTTTT...............................TTTTTTTTT.......TT.TT.TT.TT..TT....TT.............TT@@@@@@@@@@@@@@@@@@@@@@@@@@@@@@@@@@@@@@@@@@@@@@@@@@@@@@@@@@@@@@@@@@@@@@@@@@@@@@@@@@@T...................T..............TTTTTTTT.................................TTTTTTTTTTT@
TTTTT......TTTTTTTTTTTTTTTTTTTTTT......TTT..........TTTTTTTTTTTTTTTTTTTTTT............TT@@@@@@@@@@@@@@@@@@@@@@@@@@@@@@@@@@@@@@@@@@@@@@@@@@@@@@@@@@@@@@@@@@@@@@@@@@@@@@@@@@@TTT...................................TTT...................................TTTTTTTTTTT@
TTTTT......TTTT@TTTTTTTTTTTTT@@TT.................TTTTTTTTTTTTTTTTTTTTTTTT..........TTTT@@@@@@@@@@@@@@@@@@@@@@@@@@@@@@@@@@@@@@@@@@@@@@@@@@@@@@@@@@@@@@@@@@@@@@@@@@@@@@@@@@@TTT.........................................................................TTTTTTTTTTT@
TTTTT......TTTTTT@TTTTTTTTTT@TTTT.................TTTTTTTTTTTTTTTTTTTTTTTTTT........TTTT@@@@@@@@@@@@@@@@@@@@@@@@@@@@@@@@@@@@@@@@@@@@@@@@@@@@@@@@@@@@@@@@@@@@@@@@@@@@@@@@@@@TTT.........................................................................TTTTTTTTTTT@
TTTTT......TTTTTTTTTTTTTTTTTTTTTT...................TTTTTTTTTTTTTTTTTTTTTT.T........TTTT@@@@@@@@@@@@@@@@@@@@@@@@@@@@@@@@@@@@@@@@@@@@@@@@@@@@@@@@@@@@@@@@@@@@@@@@@@@@@@@@@@@TTT.........................................................................TTTTTTTTTTT@
TTTTT......TTTTTTTTTTTTTTTTTTTTTT......TTT..........TTTTTTTTTTTTTTTTTTTTTT............TT@@@@@@@@@@@@@@@@@@@@@@@@@@@@@@@@@@@@@@@@@@@@@@@@@@@@@@@@@@@@@@@@@@@@@@@@@@@@@@@@@@@TTT.............TTTTTTT...............TTT...................................TTTTTTTTTTT@
TTTTT...............................TTTTTT..............T.TT.TT..TT.TT.TT.............TT@@@@@@@@@@@@@@@@@@@@@@@@@@@@@@@@@@@@@@@@@@@@@@@@@@@@@@@@@@@@@@@@@@@@@@@@@@@@@@@@@@@TTT.............TTTTTTT............TTTTTTTT.................................TTTTTTTTTTT@
TTTTT...............................TTTTTT............................................TT@@@@@@@@@@@@@@@@@@@@@@@@@@@@@@@@@@@@@@@@@@@@@@@@@@@@@@@@@@@@@@@@@@@@@@@@@@@@@@@@@@@TTT.............TTTTTTT............TTTTTTTT..............TTTTT..............TT.......TT@
TTTTT...............................TTTTTTTTT.........................................TT@@@@@@@@@@@@@@@@@@@@@@@@@@@@@@@@@@@@@@@@@@@@@@@@@@@@@@@@@@@@@@@@@@@@@@@@@@@@@@@@@@@TTT......TTTT......................TTTTTTTT............TTTTTTT..............TT.......TT@
TTTTT...............................TTTTTTTTT.........................................TT@@@@@@@@@@@@@@@@@@@@@@@@@@@@@@@@@@@@@@@@@@@@@@@@@@@@@@@@@@@@@@@@@@@@@@@@@@@@@@@@@@@TTT......TTTT......................TTTTTT..............TTT.TTT.....................TTTT@
TTTTT..............................TTTTTTTTTT.........................................TT@@@@@@@@@@@@@@@@@@@@@@@@@@@@@@@@@@@@@@@@@@@@@@@@@@@@@@@@@@@@@@@@@@@@@@@@@@@@@@@@@@@TTT......TTTT......................TTTTTTTT........................................TTTT@
TTTTT..............................TTTTTTTTTT.........................................TT@@@@@@@@@@@@@@@@@@@@@@@@@@@@@@@@@@@@@@@@@@@@@@@@@@@@@@@@@@@@@@@@@@@@@@@@@@@@@@@@@@TTTT......TTTT......................TTTTTTTT........................................TTTT@
TTTTTT.............................TTTTTTTTTT.........................................TT@@@@@@@@@@@@@@@@@@@@@@@@@@@@@@@@@@@@@@@@@@@@@@@@@@@@@@@@@@@@@@@@@@@@@@@@@@@@@@@@@@TTTT......TT........................TTTTTTTT........................................TTTT@
TTTTTT..............................TTTTTTTTT.........................................TT@@@@@@@@@@@@@@@@@@@@@@@@@@@@@@@@@@@@@@@@@@@@@@@@@@@@@@@@@@@@@@@@@@@@@@@@@@@@@@@@@@TTTT......TT........................TTTTTTTT.......................................TTTTT@
TTTTTTT..............................TTTTTTTT.........................................TT@@@@@@@@@@@@@@@@@@@@@@@@@@@@@@@@@@@@@@@@@@@@@@@@@@@@@@@@@@@@@@@@@@@@@@@@@@@@@@@@@@TT@@TTTTTTTT........................TTTTTT.............TTT............TTTT.TTTTTT.TTTTTT@
TTTTTTTT..TTT..........TTTTTTTTTTTTTT@TTTTTTT..............TTT.....TT.....TTT.....TTT.TT@@@@@@@@@@@@@@@@@@@@@@@@@@@@@@@@@@@@@@@@@@@@@@@@@@@@@@@@@@@@@@@@@@@@@@@@@@@@@@@@@@TT@@TTTTTTTT.................TTTT.TTTTTTTTT..TTTTTTT...TTT....TTTTT...TTTTTTTTTTTTTTTTTT@
TTTTTTTTTTTTT......TTTTTTTTT@TTTTTTTTTTTTTTT..........TTTTTTTTTTTTTTTTTTTTTTTTTTTTTTTTTT@@@@@@@@@@@@@@@@@@@@@@@@@@@@@@@@@@@@@@@@@@@@@@@@@@@@@@@@@@@@@@@@@@@@@@@@@@@@@@@@@@TT@@TTTTTTTTTT.....TTTTTTTTTTTTTTTTTTTTTTTTT.TTTTTTTTTTTTTTTT.TTTTTTTTTTTTTTTTTTTTTTTTTT@
TTTT@@TTTTTT.......TTTTTT@TTTTTTTTTTTTTTTTTT..........TTTTTTTTTTTTTTTTTTTTTTTTTTTTTTTTTT@@@@@@@@@@@@@@@@@@@@@@@@@@@@@@@@@@@@@@@@@@@@@@@@@@@@@@@@@@@@@@@@@@@@@@@@@@@@@@@@@@TT@@TTTTTTTTTT.....TTTTTTTTTTTTTT@TTTTTTTTTTTTTTTTTTTTTTTTTTT.TTTTTTTTTTTT@TTTTTTTTTT@TT@
TTTTTTTTTTTTTTT...TTTTTTTTTTTTTTTTTTTTTTTTTTTTT...TTTTTTTTTTTTTTTTTTTTTTTTTTTTTTTTTTTTTTT@@@@@@@@@@@@@@@@@@@@@@@@@@@@@@@@@@@@@@@@@@@@@@@@@@@@@@@@@@@@@@@@@@@@@@@@@@@@@@@@@TTTTTTTTTTTTTTT...TTTTTTTTTTTTTTTTTTTTTTTTTTTTTTTTTTTTTTTTTTTTTTTTTTTTTTTTTTTTTTTTTTTTTTT
TTTT@@@@TTTTTTT...TTTTTTT@@@@@@@@@@@TTTTTTTTTTT...TTTTTTTT@@@@TT@TTTTTTTTTTTTTTTTTTTTTTTT@@@@@TTTTTTTTTTTTTTTTTTTTTTTTTTTTTTTTTTTTTT@@@@@@@@@@@@@@@@@@@@@@@@@@@@@@@@@@@@@@TT@@@@@@TTTTTTT...TTTTTTT@@@@@@@@TTT@@TTTTT@@@@@@@@TTTTTTT@@@@@@@@@@@@@TTT@@@@@TTT@@@@TT@
@@@@@@@@@@@@@@@@@@@@@@@@@@@@@@@@@@@@@@@@TTTTTTT...TTTTTTTTTTTTTTTTTTTTTTTTTTTTTTTTTTTTTTTTTTTTTTTTTTTTTTTTTTTTTTTTTTTTTTTTTTTTTTTTTT@@@@@@@@@@@@@@@@@@@@@@@@@@@@@@@@@@@@@@@@@@@@@@TTTTTTT...TTTTTTTTTTTTTTTTTTTTTTTTTTTTTTTTTTTTTTT@@@@@@@@@@@@@@@@@@@@@@@@@@@@@@@@
@@@@@@@@@@@@@@@@@@@@@@@@@@@@@@@@@@@@@@@@TTTTT......TTT.......TTTTTTTTTTTTTTTTTTTTTTTTTTTTTTTTTTTTTTTTTTT@@@TTTTTTTTTTTTTTTTTTTTTTTTT@@@@@@@@@@@@@@@@@@@@@@@@@@@@@@@@@@@@@@@@@@@@@@TTTTT.......TTT..........TTT...............TTTTT@@@@@@@@@@@@@@@@@@@@@@@@@@@@@@@@@
@@@@@@@@@@@@@@@@@@@@@@@@@@@@@@@@@@@@@@@@TTTTT.......TT.....TTTTTTTTTTTTTTTTTTTTTTTTTTTTTTTTTTTTTTTTTTTTTTTTTTTTTTTTTTTTTTTTTTTTTTTTT@@@@@@@@@@@@@@@@@@@@@@@@@@@@@@@@@@@@@@@@@@@@@@TT.........................................TTTTT@@@@@@@@@@@@@@@@@@@@@@@@@@@@@@@@@
@@@@@@@@@@@@@@@@@@@@@@@@@@@@@@@@@@@@@@@@TT.................TTTTTTTTT.......TTTTTTTTTTTTTTTTTTTTTTTTTT..TTTT.TTTTTTTT.........TTTTTTT@@@@@@@@@@@@@@@@@@@@@@@@@@@@@@@@@@@@@@@@@@@@@@TT..........................................TTTT@@@@@@@@@@@@@@@@@@@@@@@@@@@@@@@@@
@@@@@@@@@@@@@@@@@@@@@@@@@@@@@@@@@@@@@@@@TT.................TTTTTTTTT.......TTTTTTTTTTTTTTTTTTTTTTTTTT.......TTTTTTTT..........TTTTT@@@@@@@@@@@@@@@@@@@@@@@@@@@@@@@@@@@@@@@@@@@@@@@TT............................................TT@@@@@@@@@@@@@@@@@@@@@@@@@@@@@@@@@
@@@@@@@@@@@@@@@@@@@@@@@@@@@@@@@@@@@@@@@@TT.................TTTTTTTTT.......TTTTTTTTTTTTTTTTTTTTTTTTTT.......TTTT..............TTTTT@@@@@@@@@@@@@@@@@@@@@@@@@@@@@@@@@@@@@@@@@@@@@@@TT............................................TT@@@@@@@@@@@@@@@@@@@@@@@@@@@@@@@@@
@@@@@@@@@@@@@@@@@@@@@@@@@@@@@@@@@@@@@@@@TT....................TTTTTT................TTTTT.......TT............................TTTTT@@@@@@@@@@@@@@@@@@@@@@@@@@@@@@@@@@@@@@@@@@@@@@@TTT........................................TTTTT@@@@@@@@@@@@@@@@@@@@@@@@@@@@@@@@@
@@@@@@@@@@@@@@@@@@@@@@@@@@@@@@@@@@@@@@@@TTT...................TTTTTTTT.........TT...............TT............................TTTTT@@@@@@@@@@@@@@@@@@TTTTTTTTTTT@@@@@@@@@@@@@@@@@@TTT........................................TTTTT@@@@@@@@@@@@@@@@@@@@@@@@@@@@@@@@@
@@@@@@@@@@@@@@@@@@@@@@@@@@@@@@@@@@@@@@@@TTT...................TTTTTTTT.........TT...............TT............................TTTTT@@@@@@@@@@@@@@@@@@TTTTTTTTTTT@@@@@@@@@@@@@@@@@@TTT........................................TTTTT@@@@@@@@@@@@@@@@@@@@@@@@@@@@@@@@@
@@@@@@@@@@@@@@@@@@@@@@@@@@@@@@@@@@@@@@@@TTTT................TTTTTTTT...........TT............TT.TT............................TTTTT@@@@@@@@@@@@@@@@@TTT......TTTT@@@@@@@@@@@@@@@@@TT............................................TT@@@@@@@@@@@@@@@@@@@@@@@@@@@@@@@@@
@@@@@@@@@@@@@@@@@@@@@@@@@@@@@@@@@@@@@@@@TTTT................TTTTTTTT...........TT............TT.TT............................TTTTT@@@@@@@@@@@@@@@TTTTT.......TTTT@@@@@@@@@@@@@@@@TT............................................TT@@@@@@@@@@@@@@@@@@@@@@@@@@@@@@@@@
@@@@@@@@@@@@@@@@@@@@@@@@@@@@@@@@@@@@@@@@TTTT................TTTTTTTT...........TT............TTTTT.............................TTTT@@@@@@@@@@@@@@@TTTT.........TTT@@@@@@@@@@@@@@@@TT..........................................TTTT@@@@@@@@@@@@@@@@@@@@@@@@@@@@@@@@@
@@@@@@@@@@@@@@@@@@@@@@@@@@@@@@@@@@@@@@@@TTTT................TTTTTTTT...........TT............TTTTT..................TTTTT......TTTT@@@@@@@@@@@@@@@TTT...........TT@@@@@@@@@@@@@@@@TT.........................................TTTTT@@@@@@@@@@@@@@@@@@@@@@@@@@@@@@@@@
@@@@@@@@@@@@@@@@@@@@@@@@@@@@@@@@@@@@@@@@TTTT..................TTTTTT...........TT............TTTTT..................TTTTT......TTTT@@@@@@@@@@@@@@@TT............TT@@@@@@@@@@@@@@@@TT.......................TTT...............TTTTT@@@@@@@@@@@@@@@@@@@@@@@@@@@@@@@@@
@@@@@@@@@@@@@@@@@@@@@@@@@@@@@@@@@@@@@@@@TTTT..................TTTTTT...........................TTT..................TTTTT......TTTT@@@@@@@@@@@@@@@TT.....TT.....TT@@@@@@@@@@@@@@@@TT............TTTT.......TTT...............TTTTT@@@@@@@@@@@@@@@@@@@@@@@@@@@@@@@@@
@@@@@@@@@@@@@@@@@@@@@@@@@@@@@@@@TTTTTTTTTTTT..................TTTTTT................................................TTTTT......TTTTTTTT@@@@@@@@@@@TT....TTTT....TT@@@@@@@@@@@@@@@@TT..........TTTTTTTTTTTTTTTTTTTTTTTTTTTTTTTTTTTTT@@@@@@@@@@@@@@@@@@@@@@@@@@@@@@@@
@@@@@@@@@@@@@@@@@@@@@@@@@@@@@@@@TTTTTTTTTTTT...................TTTTT..........................................................TTTTTTTTTTTTTTTTTTTTTT....TTT.....TTTTTTTTTTTTTTTTTTTT.........TTTTTT@@@@@@@@@@@@@@@@@@@@@@@@@@@@@@@@@@@@@@@@@@@@@@@@@@@@@@@@@@@@@@@@
@@@@@@@@@@@@@@@@@@@@@@@@@@@@@@@@TTTTTTTTTTTT.................T.TTTTTT.........................................................TTTTTT..............................TTT......TTT..TTTT..........TTTTT@@@@@@@@@@@@@@@@@@@@@@@@@@@@@@@@@@@@@@@@@@@@@@@@@@@@@@@@@@@@@@@@
@@@@@@@@@@@@@@@@@@@@@@@@@@@@@@@@TTTTTTTTTTTT................TTTTTTTTT.........................................................TTTTTT..............................TTT......TTT..TTTT.............TT@@@@@@@@@@@@@@@@@@@@@@@@@@@@@@@@@@@@@@@@@@@@@@@@@@@@@@@@@@@@@@@@
@@@@@@@@@@@@@@@@@@@@@@@@@@@@@@@@TTTTT.......................TTTTTTTT...........................................................TTTTT..............................TTT......TTT..TTTT.............TT@@@@@@@@@@@@@@@@@@@@@@@@@@@@@@@@@@@@@@@@@@@@@@@@@@@@@@@@@@@@@@@@
@@@@@@@@@@@@@@@@@@@@@@@@@@@@@@@@............................TTTTTT...............................................................TTT............................................TTTT.............TT@@@@@@@@@@@@@@@@@@@@@@@@@@@@@@@@@@@@@@@@@@@@@@@@@@@@@@@@@@@@@@@@
@@@@@@@@@@@@@@@@@@@@@@@@@@@@@@@@...............................TTT...............................................................TTT............................................TTTT.............TT@@@@@@@@@@@@@@@@@@@@@@@@@@@@@@@@@@@@@@@@@@@@@@@@@@@@@@@@@@@@@@@@
@@@@@@@@@@@@@@@@@@@@@@@@@@@@@@@@.................................................................................................................................................................TT@@@@@@@@@@@@@@@@@@@@@@@@@@@@@@@@@@@@@@@@@@@@@@@@@@@@@@@@@@@@@@@@
@@@@@@@@@@@@@@@@@@@@@@@@@@@@@@@@.................................................................................................................................................................TT@@@@@@@@@@@@@@@@@@@@@@@@@@@@@@@@@@@@@@@@@@@@@@@@@@@@@@@@@@@@@@@@
@@@@@@@@@@@@@@@@@@@@@@@@@@@@@@@@.................................................................................................................................................................TT@@@@@@@@@@@@@@@@@@@@@@@@@@@@@@@@@@@@@@@@@@@@@@@@@@@@@@@@@@@@@@@@
@@@@@@@@@@@@@@@@@@@@@@@@@@@@@@@@...............................TTT...............................................................TTT............................................TTTT.............TT@@@@@@@@@@@@@@@@@@@@@@@@@@@@@@@@@@@@@@@@@@@@@@@@@@@@@@@@@@@@@@@@
@@@@@@@@@@@@@@@@@@@@@@@@@@@@@@@@...TT.......................TTTTTT...............................................................TTT............................................TTTT.............TT@@@@@@@@@@@@@@@@@@@@@@@@@@@@@@@@@@@@@@@@@@@@@@@@@@@@@@@@@@@@@@@@
@@@@@@@@@@@@@@@@@@@@@@@@@@@@@@@@TTTTTTTTTTTT................TTTTTTTT...........................................................TTTTT..............................TTT......TTT..TTTT.............TT@@@@@@@@@@@@@@@@@@@@@@@@@@@@@@@@@@@@@@@@@@@@@@@@@@@@@@@@@@@@@@@@
@@@@@@@@@@@@@@@@@@@@@@@@@@@@@@@@TTTTTTTTTTTT................TTTTTTTTT.........................................................TTTTTT..............................TTT......TTT..TTTT.............TT@@@@@@@@@@@@@@@@@@@@@@@@@@@@@@@@@@@@@@@@@@@@@@@@@@@@@@@@@@@@@@@@
@@@@@@@@@@@@@@@@@@@@@@@@@@@@@@@@TTTTTTTTTTTT...................TTTTTT.........................................................TTTTTTTTTTTTTTTTTTTTT......TT.......TTTTTTTTTTTTTTTTTT.............TT@@@@@@@@@@@@@@@@@@@@@@@@@@@@@@@@@@@@@@@@@@@@@@@@@@@@@@@@@@@@@@@@
@@@@@@@@@@@@@@@@@@@@@@@@@@@@@@@@TTTTTTTTTTTT...................TTTTT................................................TTTTT.....TTTTTTTTT@@@@@@@@@@@TT....TTTT....TT@@@@@@@@@@@@@@@@TT..........TTTTT@@@@@@@@@@@@@@@@@@@@@@@@@@@@@@@@@@@@@@@@@@@@@@@@@@@@@@@@@@@@@@@@
@@@@@@@@@@@@@@@@@@@@@@@@@@@@@@@@TTTT@@TTTTTT..................TTTTTT................................................TTTTT......TTTTT@@@@@@@@@@@@@@TT....TTTT....TT@@@@@@@@@@@@@@@@TT.........TTTTTTT@@@@@@@TTT@@@@@@@@@@@@@@@@@@TT@@@@@@@@@@@@@@@@@@@@@@@@@@@@@@@@@
@@@@@@@@@@@@@@@@@@@@@@@@@@@@@@@@@@@@@@@@TTTT..................TTTTTT...........TT..............TTT..................TTTTT......TTTT@@@@@@@@@@@@@@@TT.....TT.....TT@@@@@@@@@@@@@@@@TT..........TTTTTTTTTTTTTTTTTTTTTTTTTTTTTTTTTTTTT@@@@@@@@@@@@@@@@@@@@@@@@@@@@@@@@
@@@@@@@@@@@@@@@@@@@@@@@@@@@@@@@@@@@@@@@@TTTT..................TTTTTT...........TT............TTTTT..................TTTTT......TTTT@@@@@@@@@@@@@@@TT............TT@@@@@@@@@@@@@@@@TT............TTTT.......TTT...............TTTTT@@@@@@@@@@@@@@@@@@@@@@@@@@@@@@@@@
@@@@@@@@@@@@@@@@@@@@@@@@@@@@@@@@@@@@@@@@TTTT................TTTTTTTT...........TT............TTTTT.............................TTTT@@@@@@@@@@@@@@@TTT..........TTT@@@@@@@@@@@@@@@@TT.........................................TTTTT@@@@@@@@@@@@@@@@@@@@@@@@@@@@@@@@@
@@@@@@@@@@@@@@@@@@@@@@@@@@@@@@@@@@@@@@@@TTTT................TTTTTTTT...........TT............TTTTT.............................TTTT@@@@@@@@@@@@@@@TTTT.........TTT@@@@@@@@@@@@@@@@TT..........................................TTTT@@@@@@@@@@@@@@@@@@@@@@@@@@@@@@@@@
@@@@@@@@@@@@@@@@@@@@@@@@@@@@@@@@@@@@@@@@TTTT................TTTTTTTT...........TT............TT.TT............................TTTTT@@@@@@@@@@@@@@@TTTT........TTTT@@@@@@@@@@@@@@@@TT..........................................TTTT@@@@@@@@@@@@@@@@@@@@@@@@@@@@@@@@@
@@@@@@@@@@@@@@@@@@@@@@@@@@@@@@@@@@@@@@@@TTTT..................TTTTTT...........TT...............TT............................TTTTT@@@@@@@@@@@@@@@@@TTT......TTT@@@@@@@@@@@@@@@@@@TT............................................TT@@@@@@@@@@@@@@@@@@@@@@@@@@@@@@@@@
@@@@@@@@@@@@@@@@@@@@@@@@@@@@@@@@@@@@@@@@TT....................TTTTTTTT.........TT...............TT............................TTTTT@@@@@@@@@@@@@@@@@@TTTTTTTTTTT@@@@@@@@@@@@@@@@@@TTT.........................................TTTT@@@@@@@@@@@@@@@@@@@@@@@@@@@@@@@@@
@@@@@@@@@@@@@@@@@@@@@@@@@@@@@@@@@@@@@@@@TT....................TTTTTTTT..........................TT............................TTTTT@@@@@@@@@@@@@@@@@@@@@@@@@@@@@@@@@@@@@@@@@@@@@@@TTT........................................TTTTT@@@@@@@@@@@@@@@@@@@@@@@@@@@@@@@@@
@@@@@@@@@@@@@@@@@@@@@@@@@@@@@@@@@@@@@@@@T.....................TTTTTT..................TTTT......TT............................TTTTT@@@@@@@@@@@@@@@@@@@@@@@@@@@@@@@@@@@@@@@@@@@@@@@TTT........................................TTTTT@@@@@@@@@@@@@@@@@@@@@@@@@@@@@@@@@
@@@@@@@@@@@@@@@@@@@@@@@@@@@@@@@@@@@@@@@@T..................TTTTTTTTT.......TTTTTTTTTTTTTTTTTTTTTTTTTT.......TTTT..............TTTTT@@@@@@@@@@@@@@@@@@@@@@@@@@@@@@@@@@@@@@@@@@@@@@@TT..........................................TTTT@@@@@@@@@@@@@@@@@@@@@@@@@@@@@@@@@
@@@@@@@@@@@@@@@@@@@@@@@@@@@@@@@@@@@@@@@@T.................TTTTTTTTTT.......TTTTTTTTTTTTTTTTTTTTTTTTTT.......TTTTTTTT..........TTTTT@@@@@@@@@@@@@@@@@@@@@@@@@@@@@@@@@@@@@@@@@@@@@@@TT............................................TT@@@@@@@@@@@@@@@@@@@@@@@@@@@@@@@@@
@@@@@@@@@@@@@@@@@@@@@@@@@@@@@@@@@@@@@@@@T............TTTT.TTTTTTTTTT.......TTTTTTTTTTTTTTTTTTTTTTTTTT.TTTT..TTTTTTTT.........TTTTTTT@@@@@@@@@@@@@@@@@@@@@@@@@@@@@@@@@@@@@@@@@@@@@@TT..........................................TTTT@@@@@@@@@@@@@@@@@@@@@@@@@@@@@@@@@
@@@@@@@@@@@@@@@@@@@@@@@@@@@@@@@@@@@@@@@@T............TTTT.TTTTTTTTTTT......TTTTTTTTTTTTTTTTTTTTTTTTTTTTTTTTTTTTTTTTTTTTTTTTTTTTTTTTT@@@@@@@@@@@@@@@@@@@@@@@@@@@@@@@@@@@@@@@@@@@@@@TT..........................................TTTT@@@@@@@@@@@@@@@@@@@@@@@@@@@@@@@@@
@@@@@@@@@@@@@@@@@@@@@@@@@@@@@@@@@@@@@@@@T............TTTT....TTTTTTTT......TTTTTTTTTTTTTTTTTTTTTTTTTTTT@@@TTTTTTTTTTTTTTTTTTTTTTTTTT@@@@@@@@@@@@@@@@@@@@@@@@@@@@@@@@@@@@@@@@@@@@@@TTTTT.......TTT..................TTTT.......TTTT@@@@@@@@@@@@@@@@@@@@@@@@@@@@@@@@@
@@@@@@@@@@@@@@@@@@@@@@@@@@@@@@@@@@@@@@@@TTTTTTT...TTTTTTTTTTTTTTTTTTTTT...TTTTTTTTTTTTTTTTTTTTTTTTTTTTTTTTTTTTTTTTTTTTTTTTTTTTTTTTTT@@@@@@@@@@@@@@@@@@@@@@@@@@@@@@@@@@@@@@@@@@@@@@TTTTTTT...TTTTTTTTTTTTTTTTTTTTTTTTTTTTT...TTTTTTT@@@@@@@@@@@@@@@@@@@@@@@@@@@@@@@@
TTTT@@@@TTTTTTT...TTTTTTT@@@@@@@@@@@TTTTTTTTTTT...TTTTTTT@@@@@TTTTTTTTT...TTTTTTTTTTTTTTTTTTTTTTTT@@@@@@@@@@@@@@@@@@@@@@@@@@@@@@@@@@@@@@@@@@@@@@@@@@@@@@@@@@@@@@@@@@@@@@@@@T@@@@@@TTTTTTT...TTTTTTT@@@@@@@@@@@@@TTTTTTTTT...TTTTTTT@@@@@@@@@@@@@TTTT@@@@@@@@@@@@TT@
TTTTTTTTTTTTTTT...TTTTTTTTTTTTTTTTTTTTTTTTTTTTT...TTTTTTTTTTTTTTTTTTTTT...TTTTTTTTTTTTTTT@@@@@@@@@@@@@@@@@@@@@@@@@@@@@@@@@@@@@@@@@@@@@@@@@@@@@@@@@@@@@@@@@@@@@@@@@@@@@@@@@@TTTTTTTTTTTTTT...TTTTTTTTTTTTTTTTTTTTTTTTTTTTT...TTTTTTTTTTTTTTTTTTTTTTTTTTTTTTTTTTTTTTT
TTTT@@TTTTTTTT....TTTTTTTTTTTTTTTTTTTTTTTTTT................................TTTT....TTTT@@@@@@@@@@@@@@@@@@@@@@@@@@@@@@@@@@@@@@@@@@@@@@@@@@@@@@@@@@@@@@@@@@@@@@@@@@@@@@@@@@@TT..TTTTTTTTT....TTTTTTT.TTTTTTTTTTTTTTTTTT..........TTTTTTTTTTTTTTTTTTTTTTTTTTTTTTTTTTT
TTTTTTTTTTTTTT....TTTTTTTTTT......TTTTTTTTTT................................TTTT....TTTT@@@@@@@@@@@@@@@@@@@@@@@@@@@@@@@@@@@@@@@@@@@@@@@@@@@@@@@@@@@@@@@@@@@@@@@@@@@@@@@@@@@TT..TTTTTTTTT....TTTT....TTTTTTT...TTTTTTTT..........TTTTTTT.TTTT...........TTTTTTTT.TT@
TT@T@T....TTTT..........T..........TTTTTTT...................................TTT....TTTT@@@@@@@@@@@@@@@@@@@@@@@@@@@@@@@@@@@@@@@@@@@@@@@@@@@@@@@@@@@@@@@@@@@@@@@@@@@@@@@@@@@T...TTTTTTTTT................TTT.....TTTT.....................TT.....................TT@
TTT.TT.....TTT.....................TTTTTTT....................................T......TTT@@@@@@@@@@@@@@@@@@@@@@@@@@@@@@@@@@@@@@@@@@@@@@@@@@@@@@@@@@@@@@@@@@@@@@@@@@@@@@@@@@@T.........TTT.......................TTTTT..........................................TTTT@
TTT........TTT.....................TTTTTTT...........................................TTT@@@@@@@@@@@@@@@@@@@@@@@@@@@@@@@@@@@@@@@@@@@@@@@@@@@@@@@@@@@@@@@@@@@@@@@@@@@@@@@@@@@T...................................TTTTTT.........................................TTTTT
TTT........TTT.............TTT.T...TTTTTTT...........................................TTT@@@@@@@@@@@@@@@@@@@@@@@@@@@@@@@@@@@@@@@@@@@@@@@@@@@@@@@@@@@@@@@@@@@@@@@@@@@@@@@@@@@T...................................TTTTTT.........................................TTTTT
TTT..T.....TTT...........TTTTTTTT..TTTTTTT...........................................TTT@@@@@@@@@@@@@@@@@@@@@@@@@@@@@@@@@@@@@@@@@@@@@@@@@@@@@@@@@@@@@@@@@@@@@@@@@@@@@@@@@@@T...................................TTTTTT.........................................TTTTT
TTT..T.....TTT...........TTTTTTT...TTTTTTT........TTTTTTTTTTTTTTTTTTTTTTTTTT.........TTT@@@@@@@@@@@@@@@@@@@@@@@@@@@@@@@@@@@@@@@@@@@@@@@@@@@@@@@@@@@@@@@@@@@@@@@@@@@@@@@@@@@T....................................TTTT..........................................TTTT@
TTTT.......TTT.............TTT.....TTTTTTT........TTTTTTTTTTTTTTTTTTTTTTTTTT.........TTT@@@@@@@@@@@@@@@@@@@@@@@@@@@@@@@@@@@@@@@@@@@@@@@@@@@@@@@@@@@@@@@@@@@@@@@@@@@@@@@@@@@TTTT..................TTTTTTTTT....TTTTTTTT........................................TTTT@
TTTTT......TTT.........................TTT........TTTTTTTTTTTTTTTTTTTTTTTTTT.........TTT@@@@@@@@@@@@@@@@@@@@@@@@@@@@@@@@@@@@@@@@@@@@@@@@@@@@@@@@@@@@@@@@@@@@@@@@@@@@@@@@@@@TTTT.....TT...........TTTTTTTTT....TTTTTTTTT....TTTTTTTTT..........................TTTT@
TTTTT......TTT.........................TTT.......................TTTT................TTT@@@@@@@@@@@@@@@@@@@@@@@@@@@@@@@@@@@@@@@@@@@@@@@@@@@@@@@@@@@@@@@@@@@@@@@@@@@@@@@@@@@TTTT.....TT...........TTTTTTTTT....TTTTTTTTT....TTTTTTTTT..........................TTTT@
TTTTT......TTT.........................TTT.......................TTTT................TTT@@@@@@@@@@@@@@@@@@@@@@@@@@@@@@@@@@@@@@@@@@@@@@@@@@@@@@@@@@@@@@@@@@@@@@@@@@@@@@@@@@@T@TTTTTTT............................TTTT.......TTTTTTTT....TTT..............TTTTTTTTTT@
TTTTT..................................TTT.......................TTTT................TTT@@@@@@@@@@@@@@@@@@@@@@@@@@@@@@@@@@@@@@@@@@@@@@@@@@@@@@@@@@@@@@@@@@@@@@@@@@@@@@@@@@@T@TTTTTTTTT........................TTTTTTTTT................TTT..............TTTTTTTTTT@
TT...................................................................................TTT@@@@@@@@@@@@@@@@@@@@@@@@@@@@@@@@@@@@@@@@@@@@@@@@@@@@@@@@@@@@@@@@@@@@@@@@@@@@@@@@@@@TTTTTTTTTTT........................TTTTTTTTT................TTT..............TTTTTTTTTT@
TTTT..................................................................................TT@@@@@@@@@@@@@@@@@@@@@@@@@@@@@@@@@@@@@@@@@@@@@@@@@@@@@@@@@@@@@@@@@@@@@@@@@@@@@@@@@@@TTTTTTTTTTT........................TTTTTTTTT................TTT..............TTTTTTTTTT@
TTTT..................................................................................TT@@@@@@@@@@@@@@@@@@@@@@@@@@@@@@@@@@@@@@@@@@@@@@@@@@@@@@@@@@@@@@@@@@@@@@@@@@@@@@@@@@@TTTTTTTTTTT........................TTTTTTTTT...............TTTT..............TTTTTTTTTT@
TTTTTTTT...............................TTT............................................TT@@@@@@@@@@@@@@@@@@@@@@@@@@@@@@@@@@@@@@@@@@@@@@@@@@@@@@@@@@@@@@@@@@@@@@@@@@@@@@@@@@@T@TTTTTTT..........................TTTTTTTTT...............TTT...............TTTTTTTTTT@
TTTTTTTT...............................TTT............................................TT@@@@@@@@@@@@@@@@@@@@@@@@@@@@@@@@@@@@@@@@@@@@@@@@@@@@@@@@@@@@@@@@@@@@@@@@@@@@@@@@@@@T@TTTTTTT.............TTTTTTTTT......TTTT..................TTT...............TTTTTTTTTT@
TTTTTTTT...............................TTT............................................TT@@@@@@@@@@@@@@@@@@@@@@@@@@@@@@@@@@@@@@@@@@@@@@@@@@@@@@@@@@@@@@@@@@@@@@@@@@@@@@@@@@@TTT...................TTTTTTTTT....TTTTTTTTT....TTTTTTTTT...................TTTTTTTTTTT@
TTTTTTTT...............................TTT.........TTT.............TTTT...............TT@@@@@@@@@@@@@@@@@@@@@@@@@@@@@@@@@@@@@@@@@@@@@@@@@@@@@@@@@@@@@@@@@@@@@@@@@@@@@@@@@@@TTT...................TTTTTTTTT....TTTTTTTTT....TTTTTTTTT...................TT....TTTTT@
TT.....................................TTT.........TTT.............TTTT....TTTT.......TT@@@@@@@@@@@@@@@@@@@@@@@@@@@@@@@@@@@@@@@@@@@@@@@@@@@@@@@@@@@@@@@@@@@@@@@@@@@@@@@@@@@TTT................................TTTTTTTTT....TTTTTTTT...........................TTTT@
TT........TT.........TT..........T.....TTT.........TTT..TT.........TTTT....TTTTTT.....TT@@@@@@@@@@@@@@@@@@@@@@@@@@@@@@@@@@@@@@@@@@@@@@@@@@@@@@@@@@@@@@@@@@@@@@@@@@@@@@@@@@@TT...................................TTTT............................................TT@
TT........TT.........TT.........TT....TTTT.........TTT..TTTTTTTTT..TTT......TTTTTTTTTTTT@@@@@@@@@@@@@@@@@@@@@@@@@@@@@@@@@@@@@@@@@@@@@@@@@@@@@@@@@@@@@@@@@@@@@@@@@@@@@@@@@@@TT..................................TTTTT..........................................TTTT@
TT.....TTTT.......TTTTTT.....TTTT....TTTTT.........TTT....TTTTTTTT.TTT.......TTT@@@@@@@@@@@@@@@@@@@@@@@@@@@@@@@@@@@@@@@@@@@@@@@@@@@@@@@@@@@@@@@@@@@@@@@@@@@@@@@@@@@@@@@@@@@TT..................................TTTTTT.........................................TTTT@
TT.....TTTT.......TTTTTTT....TTTTT...TTTTT.........TTT....TTTTT@T..TTT........TT@@@@@@@@@@@@@@@@@@@@@@@@@@@@@@@@@@@@@@@@@@@@@@@@@@@@@@@@@@@@@@@@@@@@@@@@@@@@@@@@@@@@@@@@@@@TT..................................TTTTTT.........................................TTTT@
TTTT...TTTT.......TTTTTTT....TTTTT...TTTTT..TTTTTT.TTT..TTTTTTT@TT.TTT........TT@@@@@@@@@@@@@@@@@@@@@@@@@@@@@@@@@@@@@@@@@@@@@@@@@@@@@@@@@@@@@@@@@@@@@@@@@@@@@@@@@@@@@@@@@@@TT.....TTTTT.........................TTTTT...........TTTT.TTTTTTTT..TTT...TTTTT....TTTT@
TTTTTTTTTTTTT...TTTTTTTTT..TTTTTTTTT..TTTT..TTTTTT.TTT.TTTTTTTTTTT.TTT.....TT.TT@@@@@@@@@@@@@@@@@@@@@@@@@@@@@@@@@@@@@@@@@@@@@@@@@@@@@@@@@@@@@@@@@@@@@@@@@@@@@@@@@@@@@@@@@@@T......TTTTT...TT............TTTT.T..TTTT............TTTT.TTTTTTTT..TTT.TTTTTTTTTTTT@TT@
TTTTTTTTTTTTT..TTTTTTTTTTTTTTTTTTTTTTTTTTTTTTTTTTT.TTT..TTTTTTT.T..TTT....TTTTTT@@@@@@@@@@@@@@@@@@@@@@@@@@@@@@@@@@@@@@@@@@@@@@@@@@@@@@@@@@@@@@@@@@@@@@@@@@@@@@@@@@@@@@@@@@@TTTTTTTTTTTT..TTTTTTTT......TTTTTTTTTTTTTTTTTT.......TTTTTTTTT@@TTTTTTT.TTTTTTTTTTTT@TT@
TTTTTTTTTTTTT...TTTTTTTTTTTTTTTTTTTTTTTTTTTTTTTTTT.TTT.............TTT.....TTTTT@@@@@@@@@@@@@@@@@@@@@@@@@@@@@@@@@@@@@@@@@@@@@@@@@@@@@@@@@@@@@@@@@@@@@@@@@@@@@@@@@@@@@@@@@@@TTTTTTTTTTTTTTTTTTTTTTTTTTT.TTTTTTTTTTTTTTTTTT.TTTT.TT@@@TTTTT@@TTTTTTT...TTTTTTTTTT@TT@
TTTTTTTTTTTTTTTTTTTTTTTTTTTTTTTTTTTTTTTTTTTTTTTTTTTTTTTTTTTTTTTTTTTTTTTTTTTTTTTT@@@@@@@@@@@@@@@@@@@@@@@@@@@@@@@@@@@@@@@@@@@@@@@@@@@@@@@@@@@@@@@@@@@@@@@@@@@@@@@@@@@@@@@@@@@TTTTTTTTTTTTTTTTTTTTTTTTTTTTTTTTTTTTTTTTTTTTTTTTTTTTTTTTTTTTTTTTTTTTTTTTTTTTTTTTTTTTTTTT
TTTT@@@@@@@@@@@@@@TTTT@@@@@@@@@@@@@@TTTTTTTT@@@@@@@@@@@@@@@@@@@@@@@@@@@@@@@@TTTT@@@@@@@@@@@@@@@@@@@@@@@@@@@@@@@@@@@@@@@@@@@@@@@@@@@@@@@@@@@@@@@@@@@@@@@@@@@@@@@@@@@@@@@@@@@T@@@@@@@@@@@TTT@@@@@@@@TTTT@@@@@@@@@@TTTTTTTTTTTTTTTTTTTTTTTTTTTTTTTTTTT@@@@@@@TTTTTTTTT
