type octile
height 26
width 27
map
@@@TTT....TTTT..TTTTTTTTTTT
@@@TTTT...........TTTT..TTT
@@@TTT..................TTT
@@@TTTT................TTTT
@@@T.TT................TTTT
@@@T...................TTTT
@@@TT.................TTTTT
@@@TT.................TTTTT
@@@T..................TTTTT
@@@T..................TTTTT
@@@T.....................TT
@@@T.....................TT
@@@T.....TTT..TTTT.......TT
@@@T.....TTTTTTTTT......TTT
@@@TT..TTTTTTTTTTTTTT..TTTT
@@@TT..TTTTTTTTTTTTTT..TTTT
@@@TT...TTTTTTTTTTTTT..TTTT
@@@T.......TTTTTTT.....TTTT
@@@T.......TTTTTTTT.....TTT
@@@T....TTTTTTTTTTT....TTTT
@TTT....TTTTTTTTTTT....TTTT
T@TTTT..TTTTTTTTTTTT...TTTT
@@TTTT..TTTTTTTTTTTTTTTTTTT
@@TTTTTTTTTTTTTTTTTTTTTTTT@
T@@@@T@@@@@@@@@@@@@@@@@@@@@
@T@@T@@@@@@@@@@@@@@@@@@@@@@
