type octile
height 84
width 84
map
@@@@@@@@@@@@@@@@@@@@@@@@@@@@@@@@@@@@@@@TTTTT@@@@@@@@@@@@@@@@@@@@@@@@@@@@@@@@@@@@@@@@
@@@@@@@@@@@@@@@@@@@@@@@@@@@@@@@@@@@TTTTTT.TTTTTT@@@@@@@@@@@@@@@@@@@@@@@@@@@@@@@@@@@@
@@@@@@@@@@@@@@@@@@@@@@@@@@@@@@TTTTTTT........TTTTTTT@@@@@@@@@@@@@@@@@@@@@@@@@@@@@@@@
@@@@@@@@@@@@@@@@@@@@@@@@@@@@TTTTTTTTT.........TTTTTTTTTT@@@@@@@@@@@@@@@@@@@@@@@@@@@@
@@@@@@@@@@@@@@@@@@@@@@@@TTTTTTTTTTTTT.........TTTTTTTTTTTTT@@@@@@@@@@@@@@@@@@@@@@@@@
@@@@@@@@@@@@@@@@@@@@@TTTTTTTTTTTTTTTT.........TTTTTTTTTTTTTTTTT@@@@@@@@@@@@@@@@@@@@@
@@@@@@@@@@@@@@@@@@@@TTT....TTTTTTTTTT..........TTTTTTTTTT...TTTT@@@@@@@@@@@@@@@@@@@@
@@@@@@@@@@@@@@@@@@@TT.......TTTTTTTTT..........TTTTTTT........TTT@@@@@@@@@@@@@@@@@@@
@@@@@@@@@@@@@@@@@@TT.........TTTTTTTT..........TTTTT............TT@@@@@@@@@@@@@@@@@@
@@@@@@@@@@@@@@@@@TT...........TTTTTT............T................TT@@@@@@@@@@@@@@@@@
@@@@@@@@@@@@@@@@TT.............TT.................................TT@@@@@@@@@@@@@@@@
@@@@@@@@@@@@@@@TT..................................................TT@@@@@@@@@@@@@@@
@@@@@@@@@@@@@@TT....................................................TT@@@@@@@@@@@@@@
@@@@@@@@@@@@@TTT...................................................TTTT@@@@@@@@@@@@@
@@@@@@@@@@@@TTTT....................................................TTTT@@@@@@@@@@@@
@@@@@@@@@@@TT.TT.....................................................TTTT@@@@@@@@@@@
@@@@@@@@@@TTT...........................................................TTTT@@@@@@@@
@@@@@@@@@TTT............................................................TTTTTTT@@@@@
@@@@@@@@TTT..............................................................TTTTTTT@@@@
@@@@@@@TTT................................................................TTTTTT@@@@
@@@@@@TTT..................................................................TTTT@@@@@
@@@@@TTT....................................................................TTT@@@@@
@@@@@TT......................................................................TT@@@@@
@@@@@TT......................................................................TT@@@@@
@@@@TTT......................................................................TT@@@@@
@@@@TT........................................................................TT@@@@
@@@@TT....TT..................................................................TT@@@@
@@@@TTTTTTTTT................................................................TTT@@@@
@@@TTTTTTTTTTT..............................................................TTTT@@@@
@@@TTTTTTTTTTT.......................................................T.....TTTTTT@@@
@@@TTTTTTTTTTT.......................................................TTTTT.TTTTTT@@@
@@TTTTTTTTTTTTT........................................................TTTTTTT@TT@@@
@@TTTTTTTTTTTTT...........................................................TTT@TTT@@@
@@TTTTTTTTTTTT.............................................................TTTTTTT@@
@@TTTTTTTTTTTT.............................................................T.TTTTT@@
@TTTTTTTTTTTT.................................................................TTTT@@
@TTTTTTTTTTT..............................................................T....TTTT@
@TTTTTTTTTTT........................................................T.....T....TTTT@
@TTTTTTT............................................................TTT.........TTT@
TT..TTT.............................................................TTTTTT.......TT@
TT..................................................................TTTTTT.......TTT
TT.................................................................TTTTTTT.......TTT
TT................................................................TTTTTTTT........TT
TT................................................................TTTTTTTT........TT
TT................................................................TTTTTTTTT.......T@
@TT...............................................................TTTTTTTTT.......T@
@TT.................................................................TTTTTTTTTTT...T@
@TT..................................................................TTTTTT..TTTTT@@
@@T....................................................................T........TT@@
@@TT............................................................................TT@@
@@TTTT........................................................................TTTT@@
@@TTTT........................................................................TTT@@@
@@@TTT........................................................................TTT@@@
@@@TTT........................................................................TTT@@@
@@@TT..........................................................................TT@@@
@@@TT.........................................................................TT@@@@
@@@@TT........................................................................TT@@@@
@@@@TT........................................................................TT@@@@
@@@@TT.......................................................................TT@@@@@
@@@@TTT......................................................................TT@@@@@
@@@@@TT......................................................................TT@@@@@
@@@@@TT.....................................................................TTT@@@@@
@@@@@TTT....................................................................TT@@@@@@
@@@@@@TTT........TTT.......................................................TTT@@@@@@
@@@@@@@TTT...TTT.TTTT.....................................................TTT@@@@@@@
@@@@@@@@TTTTTTTTTTTTTTT..................................................TTT@@@@@@@@
@@@@@@@@@TTTTTTTTTTTTTT.................................................TTT@@@@@@@@@
@@@@@@@@@@TTTTTTTTTTTTT.............................................TT.TTT@@@@@@@@@@
@@@@@@@@@@@TTTTTTTTTTT.............................................TTTTTT@@@@@@@@@@@
@@@@@@@@@@@@TTTTTTTT...............................................TTTTT@@@@@@@@@@@@
@@@@@@@@@@@@@TTTTTT................................................TTTT@@@@@@@@@@@@@
@@@@@@@@@@@@@@TTTT.................................................TTT@@@@@@@@@@@@@@
@@@@@@@@@@@@@@@TT.................................................TTT@@@@@@@@@@@@@@@
@@@@@@@@@@@@@@@@TT...............................................TTT@@@@@@@@@@@@@@@@
@@@@@@@@@@@@@@@@@TTT............................TTTTTTT.........TTT@@@@@@@@@@@@@@@@@
@@@@@@@@@@@@@@@@@@TTT.........................TTTTTTTTT........TTT@@@@@@@@@@@@@@@@@@
@@@@@@@@@@@@@@@@@@@TTT........................TTTTTTTTTTT.....TTT@@@@@@@@@@@@@@@@@@@
@@@@@@@@@@@@@@@@@@@@TTTT.....................TTTTTTTTTTTT..TTTTT@@@@@@@@@@@@@@@@@@@@
@@@@@@@@@@@@@@@@@@@@@@TTTTTT..TT.............TTTTTTTTTTTTTTTTT@@@@@@@@@@@@@@@@@@@@@@
@@@@@@@@@@@@@@@@@@@@@@@@@TTTTTTTTT...........TTTTTTTTTTTTT@@@@@@@@@@@@@@@@@@@@@@@@@@
@@@@@@@@@@@@@@@@@@@@@@@@@@@@@TTTTT...........TTTTTTTTTT@@@@@@@@@@@@@@@@@@@@@@@@@@@@@
@@@@@@@@@@@@@@@@@@@@@@@@@@@@@@@@@TTTTT.......TTTTTT@@@@@@@@@@@@@@@@@@@@@@@@@@@@@@@@@
@@@@@@@@@@@@@@@@@@@@@@@@@@@@@@@@@@@@TTTTTTTTTTT@@@@@@@@@@@@@@@@@@@@@@@@@@@@@@@@@@@@@
@@@@@@@@@@@@@@@@@@@@@@@@@@@@@@@@@@@@@@@@TTT@@@@@@@@@@@@@@@@@@@@@@@@@@@@@@@@@@@@@@@@@
