type octile
height 95
width 48
map
@@@@@@@@@@@@@@TTTTTTTT...TTTTTTT@@@@@@@@@@@@@@@@
@@@@@@@@@@@@@@TT..TTTT...TTT...T@@@@@@@@@@@@@@@@
@@@@@@@@@@@@@@TT...............T@@@@@@@@@@@@@@@@
@@@@@@@@@@@@@@TT...............T@@@@@@@@@@@@@@@@
@@@@@@@@@@@@@@TT...............T@@@@@@@@@@@@@@@@
@@@@@@@@@@@@@@TT...............T@@@@@@@@@@@@@@@@
@@@@@@@@@@@@@@TT...............T@@@@@@@@@@@@@@@@
@@@@@@@@@@@@@@TT...............T@@@@@@@@@@@@@@@@
@@@@@@@@@@@@@@TT...............T@@@@@@@@@@@@@@@@
@@@@@@@@@@@@@@TT...............T@@@@@@@@@@@@@@@@
@@@@@@@@@@@@@@TT...............T@@@@@@@@@@@@@@@@
@@@@@@@@@@@@@@TT...............T@@@@@@@@@@@@@@@@
@@@@@@@@@@@TTTTTTT...........TTTTTT@@@@@@@@@@@@@
TTTTTTTTTTTTTTTTTT..........TTTTTTTTTTTTTTTTTT@@
TTTTTTTTTTTTTTTTTT..........TTTTTTTTTTTTTTTTTT@@
TTTTTTTTTTTTTTTTTT...........TTTTTTTTTTTTTTTTT@@
TTTTTTTT@@@TTTTTTT...........TTTTTTT@@@TTTTTTT@@
TTTTTTT@@@@@@@TT...............TTTT@@TTTTTTTTT@@
TTTTTT@@@TT@TTTTT..............TTTT@TTTTTTTTTT@@
TTTTT@@TTTTT@TTTTT.............TTTT@TTTTTTTTTT@@
TTTT@@@TTTTTTTTTTTTT...........TTTT@TTTTTTTTTT@@
TTT@@@@TTTTTTTTTTTTT..........TTTTT@@TTTTTTTTT@@
TTTTTTTTTTTTTTTTTTT...........TTTTTTTTTTTTTTTT@@
TTTTTTTTTTTTTTTTTT...........TTTTTTTTTTTTTTTTT@@
TTTTTTTTTTTTTTTTTT..........TTTTTTTTTTTTTTTTTTTT
TTTTTTTTT..TTTTTT...........TTTTTT.TTTTTTTTTTTTT
TTTTTTT.....TTTT............TTTTT...T......TTTTT
TTT...........T.............TTTTT..........TTTTT
TTT........................TTTTT...........TTTTT
TTT........................TTTTT.............TTT
TTT........................TTTTT.............TTT
TTT........................TTTTT...........TTTTT
TTT........................TTTTT...TTTTTTTTTTTTT
TTT......TTT...............TTTTT...TTTTTTTTTTTTT
TTT......TTT...............TTTTT...TTTTTTTTTTTTT
TTT......TTT...............TTTTT....TTTTTTTTTTTT
TTT......TTT...............TTTTT....TTTTTTTTTT@@
TTT........................TTTTT....TTTTTTTTTT@@
TTT.......................TTTTTT....TTTTTTTTTT@@
TTT............TT.........TTTTTT....TTTTTTTTTT@@
TTT.......TTTTTTT..........TTTTT....TTTTTTTTTT@@
TTT.....TTTTTTTTT........TTTTTTTTTT.TTTTTTTTTT@@
TTT.....TTTTTTTTTT.......TTTTTTTTTT..TTTTTTTTT@@
TTT.....TTTTTTTTTT.......TTTTTTTTTT..TTTTTTTTT@@
TTT......TTTTT...........TTTTTTTTTT..TTTTTTTTT@@
TTT......................................TTTTT@@
TTTTTTTTT...............................TTTTTT@@
TTTTTTTTT..............................TTTTTTT@@
TTTTTTTTT..............................TTTTTTT@@
TTTTTTTTT...............................TTTTTT@@
TTTTTTTTT...............................TTTTTT@@
TTTTTTTTT..................................TTT@@
TTTTTTTTT..................................TTT@@
TTTTTTTT.......TTTTTTTTTTTTTTT.............TTT@@
TTTTTTTT.......TTTTTTTTTTTTTTT.............TTT@@
TTTTTTTT.......TTTTTTTTTTTTTTT............TTTT@@
TTTTTTTT........TTTTTTTTTTTTTT...........T@TTT@@
TTTTT...........TTTTTTTTTTTTTT..........TTTTTT@@
TTTTTT..........TTTTTTTTTTTTTT..........TTTTTT@@
TTTTTT..........TTTTTTTTTTTTTT..........TTTTTT@@
@@TTTTTTTT.......TTTTTTTTTTTTT......TTTTTTTT@@@@
@@TTTTTTTT.........TTTTTTTTT........TTTTTTTT@@@@
@@TTTTTTTT.........TTTTTTTTT........TTTTTTTT@@@@
@@TTTTTTTT.........TTTTTTTTT.........TTTTTTT@@@@
@@TTTTTTTT.........TTTTTTTTT.........TTTTTTT@@@@
@@TTTTTTTTT........TTTTTTTT.........TTTTTTTT@@@@
@@TTTTTTTTT..........TTTTT..........TTTTTTTT@@@@
@@TTTTTTTTT..........TTTT...........TTTTTTTT@@@@
@@TTTTTTTTT..........TTTT...........TTTTTTTT@@@@
@@TTTTTTTT...........TTTT............TTTTTTT@@@@
@@TTTTTTTT...........................TTTTTTT@@@@
@@TTTTTTTT..........................TTTTTTTT@@@@
@@TTTTTTTT..........................TTTTTTTT@@@@
@@TTTTTTTT..........................TTTTTTTT@@@@
@@TTT................TTTT.................TT@@@@
@@TT.................TTTT..................T@@@@
@@TT.................TTTT..................T@@@@
@@TT.................TTTTT.................T@@@@
@@TT.................TTTTT.................T@@@@
@@TT...............TTTTTTTT................T@@@@
@@TTT.............TTTTTTTTTTT.............TT@@@@
@@TTT.............TTTTTTTTTTT.............TT@@@@
@@TTTTT.........TTTTTTTTTTTTTTTTTTTTTTTTTTTT@@@@
@@TTTTTTTTTTTTTTTTTTTTTTTTTTTTTTTTTTTTTTTTTT@@@@
@@TTTTTTTTTTTTTTTTTT@@@@@@TTTTTTTTTTTTTTTTTT@@@@
@@TTTTTTTTTTTTTTTTTT@@@@@@TTTTTTTTTTTTTTTTTT@@@@
@@TTTTTTTTTTTTTTTTTT@@@@@@TTTTTTTTTTTTTTTTTT@@@@
@@TTTT@TTTTTTTTT@TTT@@@@@@TTTT@@@@@@@@@@@TTT@@@@
@@TTTTT@@@@@@@@TTTTT@@@@@@TTTT@@@@@@@@@@@TTT@@@@
@@TTTTTT@@@@@@TTTTTT@@@@@@TTT@@@@@@@@@@@@TTT@@@@
@@TTTTTTT@@@@TTTTTTT@@@@@@TTTT@@@@@@@@@@@TTT@@@@
@@TTTTTTTTTTTTTTTTTT@@@@@@TTTTT@@@@@@@@@TTTT@@@@
@@TTTTTTTTTTTTTTTTTT@@@@@@TTTTTT@@@@@@@TTTTT@@@@
@@TTTTTTTTTTTTTTTTTT@@@@@@TTTTTTTTTTTTTTTTTT@@@@
@@TT@TTTTTTTTTTTTT@T@@@@@@TT@TTTTTTTTTTTTT@T@@@@
