type octile
height 84
width 84
map
@@@@@@@@@@@@@@@@@@@@@@@@@@@@@@@@@@@@@@@@TTTT@@@@@@@@@@@@@@@@@@@@@@@@@@@@@@@@@@@@@@@@
@@@@@@@@@@@@@@@@@@@@@@@@@@@@@@@@@@@@TTTTTTTTTTT@@@@@@@@@@@@@@@@@@@@@@@@@@@@@@@@@@@@@
@@@@@@@@@@@@@@@@@@@@@@@@@@@@@@@@TTTTTTTTTTTTTTTTTTT@@@@@@@@@@@@@@@@@@@@@@@@@@@@@@@@@
@@@@@@@@@@@@@@@@@@@@@@@@@@@@@TTTTTTTTTTTTTTTTTTTTTTTTTT@@@@@@@@@@@@@@@@@@@@@@@@@@@@@
@@@@@@@@@@@@@@@@@@@@@@@@@TTTTTTTTTTTTTTTTTTTTTTTTTTTTTTTTT@@@@@@@@@@@@@@@@@@@@@@@@@@
@@@@@@@@@@@@@@@@@@@@@TTTTTT...T..TTTTTTTTTTTTTTTTT.TTT.TTTTTTT@@@@@@@@@@@@@@@@@@@@@@
@@@@@@@@@@@@@@@@@@@@TTTT.........TTTTTTTTTTTTTTTTT........TTTTTT@@@@@@@@@@@@@@@@@@@@
@@@@@@@@@@@@@@@@@@@TTT...........TTTTTTTTTTTTTTTTT............TTT@@@@@@@@@@@@@@@@@@@
@@@@@@@@@@@@@@@@@@TT.............TTTTTTTTTTTTTTTTT.............TTT@@@@@@@@@@@@@@@@@@
@@@@@@@@@@@@@@@@@TT...............T...TTTTTTT...................TTT@@@@@@@@@@@@@@@@@
@@@@@@@@@@@@@@@@TT..............T.....TTTTTTT.........T..........TTT@@@@@@@@@@@@@@@@
@@@@@@@@@@@@@@@TT.................................................TTT@@@@@@@@@@@@@@@
@@@@@@@@@@@@@@TT................T..................................TTT@@@@@@@@@@@@@@
@@@@@@@@@@@@@TTT....................................................TTT@@@@@@@@@@@@@
@@@@@@@@@@@@TTTTT...................................................TTTT@@@@@@@@@@@@
@@@@@@@@@@@TTTTTTT...................................................TTTT@@@@@@@@@@@
@@@@@@@@@@TTTTTTTT.....................................................TTT@@@@@@@@@@
@@@@@@@@@TTTTTTTTTTTTTTTTT..............................................TTT@@@@@@@@@
@@@@@@@@TTTTTTTTTTTTTTTTTTT..............................................TTT@@@@@@@@
@@@@@@@TTT....TTTTTTTTTTTTTT..............................................TTT@@@@@@@
@@@@@@TTT.....TTTTTTTTTTTTTT...............................................TTT@@@@@@
@@@@@TTT......TTTTTTTTTTTTTT................................................TT@@@@@@
@@@@@TT.......TTTTTTTTTTTTT..................................................TT@@@@@
@@@@@TT........TTTTTTTTTTTT..................................................TT@@@@@
@@@@TTT......................................................................TT@@@@@
@@@@TT........................................................................T@@@@@
@@@@TT........................................................................TT@@@@
@@@@TT........................................................................TT@@@@
@@@TT..........................................................................T@@@@
@@@TT................................................................T.........TT@@@
@@@TT................................................................TTTT.....TTT@@@
@@TTT............................................................T...TTTTTT...TTT@@@
@@TTT....................................................................TTTT..TT@@@
@@TTT......................................................................TTT.TTT@@
@@TT........................................................................TTT@TT@@
@TT..........................................................................TTTTT@@
@TT...........................................................................TTTT@@
@TT.................................................................T..........TTTT@
@TT.................................................................TTT.........TTT@
TT..................................................................TTTT........TTT@
TT...............................................................T.....TT........TT@
TT..............................................................T.......TT.......TTT
TT.......................................................................T........TT
TT............................................................T..........T........TT
TT.......................................................................T........T@
@TT......................................................................TT.......T@
@TT......................................................................TTTTT...TT@
@TT.........................................................................TTTTTT@@
@TT.............................................................................TT@@
@@TT............................................................................TT@@
@@TTT..........................................................................TTT@@
@@TTT.........................................................................TTT@@@
@@TTT.........................................................................TTT@@@
@@@TTT........................................................................TTT@@@
@@@TT..........................................................................TT@@@
@@@TT.........................................................................TT@@@@
@@@@TT........................................................................TT@@@@
@@@@TT........................................................................TT@@@@
@@@@TT.......................................................................TT@@@@@
@@@@TTT......................................................................TT@@@@@
@@@@@TT......................................................................TT@@@@@
@@@@@TT.....................................................................TTT@@@@@
@@@@@TTT....................................................................TT@@@@@@
@@@@@@TTT..................................................................TTT@@@@@@
@@@@@@@TTT.....................T..........................................TTT@@@@@@@
@@@@@@@@TTT..................TTTTT.......................................TTT@@@@@@@@
@@@@@@@@@TTT................TTTTTTT.....................................TTT@@@@@@@@@
@@@@@@@@@@TTT...............TTTTTTT....................................TTT@@@@@@@@@@
@@@@@@@@@@@TTT..............TTTTTTTT.................................TTTT@@@@@@@@@@@
@@@@@@@@@@@@TTT.............TTTTTTTTT...............................TTTT@@@@@@@@@@@@
@@@@@@@@@@@@@TTT............TTTTTTTTT...............................TTT@@@@@@@@@@@@@
@@@@@@@@@@@@@@TT.............TTTTTTTTT.............................TTT@@@@@@@@@@@@@@
@@@@@@@@@@@@@@@TT.............TTTTTTTT............................TTT@@@@@@@@@@@@@@@
@@@@@@@@@@@@@@@@TT............TTTTTTTTT.............T............TTT@@@@@@@@@@@@@@@@
@@@@@@@@@@@@@@@@@TT............TTTTTTTT............T............TTT@@@@@@@@@@@@@@@@@
@@@@@@@@@@@@@@@@@@TT...........TTTTTTT............T............TTT@@@@@@@@@@@@@@@@@@
@@@@@@@@@@@@@@@@@@@TT.........TTTTTTT.........................TTT@@@@@@@@@@@@@@@@@@@
@@@@@@@@@@@@@@@@@@@@TTT.......TTTTTT........................TTTT@@@@@@@@@@@@@@@@@@@@
@@@@@@@@@@@@@@@@@@@@@TTTTTT...TTTTT..................T...TTTTTT@@@@@@@@@@@@@@@@@@@@@
@@@@@@@@@@@@@@@@@@@@@@@@TTTTTTTTTT................TTTTTTTTT@@@@@@@@@@@@@@@@@@@@@@@@@
@@@@@@@@@@@@@@@@@@@@@@@@@@@@TTTTTT................TTTTT@@@@@@@@@@@@@@@@@@@@@@@@@@@@@
@@@@@@@@@@@@@@@@@@@@@@@@@@@@@@@@TTTTT.........TTTTTT@@@@@@@@@@@@@@@@@@@@@@@@@@@@@@@@
@@@@@@@@@@@@@@@@@@@@@@@@@@@@@@@@@@@@TTTTTTTTTTTT@@@@@@@@@@@@@@@@@@@@@@@@@@@@@@@@@@@@
@@@@@@@@@@@@@@@@@@@@@@@@@@@@@@@@@@@@@@@TTTTT@@@@@@@@@@@@@@@@@@@@@@@@@@@@@@@@@@@@@@@@
