type octile
height 145
width 181
map
@@@@@@@@@@@@@TT@@@@@@@@@@@@@@@@@@@@@@@@@@@@@@@@@@@@@@@@@@@@@@@@@@@@@@@@@@@@@@@@@@@@@@@@@@@@@@@@@@@@@@@@@@@@@@@@@@@@@@@@@@@@@@@@@@@@@@@@@@@@@@@@@@@@@@@@@@@@@@@@@@@@@@@@@@@@@@@@@@@@@@
@@@@@@@@@@@@TTTT@@@@@@@@@@@@@@@@@@@@@@@@@@@@@@@@@@@@@@@@@@@@@@@@@@@@@@@@@@@@@@@@@@@@@@@@@@@@@@@@@@@@@@@@@@@@@@@@@@@@@@@@@@@@@@@@@@@@@@@@@@@@@@@@@@@@@@@@@@@@@@@@@@@@@@@@@@@@@@@@@@@@@
@@@@@@@@@@@@TTTTTT@@@@@@@@@@@@@@@@@@@@@@@@@@@@@@@@@@@@@@@@@@@@@@@@@@@@@@@@@@@@@@@@@@@@@@@@@@@@@@@@@@@@@@@@@@@@@@@@@@@@@@@@@@@@@@@@@@@@@@@@@@@@@@@@@@@@@@@@@@@@@@@@@@@@@@@@@@@@@@@@@@@
@@@@@@@@@@@TTTTTTTTT@@@@@@@@@@@@@@@@@@@@@@@@@@@@@@@@@@@@@@@@@@@@@@@@@@@@@@@@@@@@@@@@@@@@@@@@@@@@@@@@@@@@@@@@@@@@@@@@@@@@@@@@@@@@@@@@@@@@@@@@@@@@@@@@@@@@@@@@@@@@@@@@@@@@@@@@@@@@@@@@@
@@@@@@@@@@@TTTTTTTTTT@@@@@@@@@@@@@@@@@@@@@@@@@@@@@@@@@@@@@@@@@@@@@@@@@@@@@@@@@@@@@@@@@@@@@@@@@@@@@@@@@@@@@@@@@@@@@@@@@@@@@@@@@@@@@@@@@@@@@@@@@@@@@@@@@@@@@@@@@@@@@@@@@@@@@@@@@@@@@@@@
@@@@@@@@@@TTTTTTTTTTTTT@@@@@@@@@@@@@@@@@@@@@@@@@@@@@@@@@@@@@@@@@@@@@@@@@@@@@@@@@@@@@@@@@@@@@@@@@@@@@@@@@@@@@@@@@@@@@@@@@@@@@@@@@@@@@@@@@@@@@@@@@@@@@@@@@@@@@@@@@@@@@@@@@@@@@@@@@@@@@@
@@@@@@@@@@TTTTTTTTT.TTTT@@@@@@@@@@@@@@@@@@@@@@@@@@@@@@@@@@@@@@@@@@@@@@@@@@@@@@@@@@@@@@@@@@@@@@@@TT@@@@@@@@@@@@@@@@@@@@@@@@@@@@@@@@@@@@@@@@@@@@@@@@@@@@@@@@@@@@@@@@@@@@@@@@@@@@@@@@@@@
@@@@@@@@@TTTTTTTTT....TTTT@@@@@@@@@@@@@@@@@@@@@@@@@@@@@@@@@@@@@@@@@@@@@@@@@@@@@@@@@@@@@@@@@@TTTTTTTTTT@@@@@@@@@@@@@@@@@@@@@@@@@@@@@@@@@@@@@@@@@@@@@@@@@@@@@@@@@@@@@@@@@@@@@@@@@@@@@@@
@@@@@@@@TTTTTTTTT.......TTTT@@@@@@@@@@@@@@@@@@@@@@@@@@@@@@@@@@@@@@@@@@@@@@@@@@@@@@@@@@@@TTTTTTTTTTTTTTTTTT@@@@@@@@@@@@@@@@@@@@@@@@@@@@@@@@@@@@@@@@@@@@@@@@@@@@@@@@@@@@@@@@@@@@@@@@@@@
@@@@@@@@TTTTTTT........TTTTTTT@@@@@@@@@@@@@@@@@@@@@@@@@@@@@@@@@@@@@@@@@@@@@@@@@@@@@@TTTTTT......TT.....TTTTTTT@@@@@@@@@@@@@@@@@@@@@@@@@@@@@@@@@@@@@@@@@@@@@@@@@@@@@@@@@@@@@@@@@@@@@@@
@@@@@@@TTTTTTTTT.......TTTTTTTT@@@@@@@@@@@@@@@@@@@@@@@@@@@@@@@@@@@@@@@@@@@@@@@@@@TTTTTT....................TTTTTT@@@@@@@@@@@@@@@@@@@@@@@@@@@@@@@@@@@@@@@@@@@@@@@@@@@@@@@@@@@@@@@@@@@@
@@@@@@@T.TTTTTTTTTT......TTTTTTTT@@@@@@@@@@@@@@@@@@@@@@@@@@@@@@@@@@@@@@@@@@@@TTTTTT............................TTTTTT@@@@@@@@@@@@@@@@@@@@@@@@@@@@@@@@@@@@@@@@@@@@@@@@@@@@@@@@@@@@@@@@
@@@@@@T...TTTTTTTTTT.....TTTTTTTTTT@@@@@@@@@@@@@@@@@@@@@@@@@@@@@@@@@@@@@@@@TTTT...................................TTTTT@@@@@@@@@@@@@@@@@@@@@@@@@@@@@@@@@@@@@@@@@@@@@@@@@@@@@@@@@@@@@@
@@@@@T....TTTTTTTTTT.....TTTTT...TTTT@@@@@@@@@@@@@@@@@@@@@@@@@@@@@@@@@@@@@TTTTT....................................TTTTT@@@@@@@@@@@@@@@@@@@@@@@@@@@@@@@@@@@@@@@@@@@@@@@@@@@@@@@@@@@@@
@@@@@T......TTTTTTT........TTT....TTTT@@@@@@@@@@@@@@@@@@@@@@@@@@@@@@@@@@@TTTTTTTT...................................TTTTT@@@@@@@@@@@@@@@@@@@@@@@@@@@@@@@@@@@@@@@@@@@@@@@@@@@@@@@@@@@@
@@@@T........TTTTT..................TTTT@@@@@@@@@@@@@@@@@@@@@@@@@@@@@@@@TTTTTTTTTT...................................TTTTT@@@@@@@@@@@@@@@@@@@@@@@@@@@@@@@@@@@@@@@@@@@@@@@@@@@@@@@@@@@
@@@@T..........TTT....................TTTT@@@@@@@@@@@@@@@@@@@@@@@@@@@@@TTTTTTTTTTTT.................................TTTTTT@@@@@@@@@@@@@@@@@@@@@@@@@@@@@@@@@@@@@@@@@@@@@@@@@@@@@@@@@@@
@@@T...................................TTTTT@@@@@@@@@@@@@@@@@@@@@@@@@@TTTTTTTTTTTTT................................TTTTTT@.@@@@@@@@@@@@@@@@@@@@@@@@@@@@@@@@@@@@@@@@@@@@@@@@@@@@@@@@@@
@@TTTT................................TTTTTTTT@@@@@@@@@@@@@@@@@@@@@@@TTTTTTTTTTTTT................................TTTTTT@T..@@@@@@@@@@@@@@@@@@@@@@@@@@@@@@@@@@@@@@@@@@@@@@@@@@@@@@@@@
@@TTTT................................TTTTTTTTT@@@@@@@@@@@@@@@@@@@@@TTTTTTTTTTTTTT...............................TTTTTT@TT...@@@@@@@@@@@@@@@@@@@@@@@@@@@@@@@@@@@@@@@@@@@@@@@@@@@@@@@@
@TTTT.................................TTTTTTTTTT@@@@@@@@@@@@@@@@@@@TTTTTTTT....T................................TTTTTTTTT.....@@@@@@@@@@@@@@@@@@@@@@@@@@@@@@@@@@@@@@@@@@@@@@@@@@@@@@@
@TTTT...............................T...TTTT..TTTT@@@@@@@@@@@@@@@@TTTTTTTT.................................TTT.TTTTTTTTT.......@@@@@@@@@@@@@@@@@@@@@@@@@@@@@@@@@@@@@@@@@@@@@@@@@@@@@@
TTTTT..............................TTTTTTTTT...TTTTT@@@@@@@@@@@@@TTTTTTTTTT...........................TTTT.TTT..TTTTTTT.........@@@@@@@@@@@@@@@@@@@@@@@@@@@@@@@@@@@@@@@@@@@@@@@@@@@@@
TTTTT..............................TTTTTTTTT..TTT@TTT@@@@@@@@@@@TTTTTTTTTT............................TTTT.......TTTTT........T@@T@@@@@@@@@@@@@@@@@@@@@@@@@@@@@@@@@@@@@@@@@@@@@@@@@@@
TTTT................................TTTTTTTT..TTTT@TTTT@@@@@@@@TTTTTTTT...............................TTTT.......TTTT........T@TTTT@@@@@@@@@@@@@@@@@@@@@@@@@@@@@@@@@@@@@@@@@@@@@@@@@@
TTT...................................TTTTT.....TTTTTTTTTT@@@@TTTTTTT..................................TTT......TTTT........T@TTTTTT@@@@@@@@@@@@@@@@@@@@@@@@@@@@@@@@@@@@@@@@@@@@@@@@@
TTT...................................TTTTT.......TTTTTTTTTT@TTTTTT............................................TTTT........T@TTTTTTTT@@@@@@@@@@@@@@@@@@@@@@@@@@@@@@@@@@@@@@@@@@@@@@@@
TTT...................................TTTTT........TTTTTTTTTTTTT...............................................TTT........T@TTTTTTTTT@@@@@@@@@@@@@@@@@@@@@@@@@@@@@@@@@@@@@@@@@@@@@@@@
TTT...................................TTTTT...........TT@TTTTTTT................................................T........T@TTTTTTTTTTT@@@@@@@@@@@@@@@@@@@@@@@@@@@@@@@@@@@@@@@@@@@@@@@
TTT...................................TTTT............TT@TTTTTT.........................................................TTTTTTTTT..TTT@@@@@@@@@@@@@@@@@@@@@@@@@@@@@@@@@@@@@@@@@@@@@@@
TTTT...................................TT.............TTTTTTTT.........................................................TTTTTTTTT....TT@@@@@@@@@@@@@@@@@@@@@@@@@@@@@@@@@@@@@@@@@@@@@@@
TTTT..................................................TTTTTTT.........................................................TTTTTTTTT......TT@@@@@@@@@@@@@@@@@@@@@@@@@@@@@@@@@@@@@@@@@@@@@@
TTT...................................................TT.TT....TTTTT.....................TT..........................TTTT@TTTT.......TT@@@@@@@@@@@@@@@@@@@@@@@@@@@@@@@@@@@@@@@@@@@@@@
TTT.............TTT......................................T..........T....................TT..........................TTT.TTTT........TT@@@@@@@@@@@@@@@@@@@@@@@@@@@@@@@@@@@@@@@@@@@@@@
TTT.............TTT.................TTT.................TT..........T....................................TT..............TT...........T@@@@@@@@@@@@@@@@@@@@@@@@@@@@@@@@@@@@@@@@@@@@@@
TT@TTTTTT....TTTTTTTT...........TT..TTTT................TT.........T.....................................TT.............TTT...........TT@@@@@@@@@@@@@@@@@@@@@@@@@@@@@@@@@@@@@@@@@@@@@
TTTTTTTTT....TTTTTTTT......TT...TTTTTTTT................TT.........T....................................................TT............TT@@@@@@@@@@@@@@@@@@@@@@@@@@@@@@@@@@@@@@@@@@@@@
TTTTTTTTT....TTTTTTTT......TT...TTTTTTTT................TT.........T....................................................TTT............T@@@@@@@@@@@@@@@@@@@@@@@@@@@@@@@@@@@@@@@@@@@@@
TTTTTTTT.....TTTTTTTT.....TTTTTTTTTTTTTT...............TTT.........T....................................................TTT............T@@@@@@@@@@@@@@@@@@@@@@@@@@@@@@@@@@@@@@@@@@@@@
TTTT.........TTTTTTTT.....TTTTTTTTTTTTTT...............TT................................................................TT............TT@@@@@@@@@@@@@@@@@@@@@@@@@@@@@@@@@@@@@@@@@@@@
TT.........................TTTTTTTTTTTT............TTT.TT..........T.....................................................TT............TT@@@@@@@@@@@@@@@@@@@@@@@@@@@@@@@@@@@@@@@@@@@@
TT...........................TTTTTTTTTT............TTT.TTT........TT....................................................TTT.............T@@@@@@@@@@@@@@@@@@@@@@@@@@@@@@@@@@@@@@@@@@@@
TT............................TTTTTTTTT.............TTTTTT..TTTT..TT....................................................TTTT............TT@@@@@@@@@@@@@@@@@@@@@@@@@@@@@@@@@@@@@@@@@@@
TTTT..........................TTTTTTTTT...........TTT@TTTT......TT...................................T..................TTTT............TT@@@@@@@@@@@@@@@@@@@@@@@@@@@@@@@@@@@@@@@@@@@
TTTT..........................TTTTTTTT............TTT@TTTT......................TT.......................................TTT............TT@@@@@@@@@@@@@@@@@@@@@@@@@@@@@@@@@@@@@@@@@@@
TTTT..........................TTTTTTTT.............TTTTTT.......................TT..............T.......................TTTT............TT@@@@@@@@@@@@@@@@@@@@@@@@@@@@@@@@@@@@@@@@@@@
TTTT..........................TTTTTTTT.............TTTTTTT.....................................TTTT.....................TTTTT...........TTT@@@@@@@@@@@@@@@@@@@@@@@@@@@@@@@@@@@@@@@@@@
TTTT..........................TTTTTTTTTTTT........TTTTTTTT......................................TTT.....T...............TTTTT...........TTT@@@@@@@@@@@@@@@@@@@@@@@@@@@@@@@@@@@@@@@@@@
TTTT...........................TTTTTTTTTTTT........TTTTTTT.......................................T........................TT............TTT@@@@@@@@@@@@@@@@@@@@@@@@@@@@@@@@@@@@@@@@@@
TTTT...........................TTTTTTTTTTTT........TTTTTTT....................................................TT........................TTT@@@@@@@@@@@@@@@@@@@@@@@@@@@@@@@@@@@@@@@@@@
TTTTTTTTTT.....................TTTTTTT..............TTTTTT....................................................TT..............TTT.......TT@@@@@@@@@@@@@@@@@@@@@@@@@@@@@@@@@@@@@@@@@@@
@@@@@@@@@T.....................TTTTTTTTTTTT..........TTTT....................................................................TTTT........T@@@@@@@@@@@@@@@@@@@@@@@@@@@@@@@@@@@@@@@@@@@
@@@@@@@@@T.....................TTTTT@TTTTTT...........TTTT...................................................................TTTT.......TT@@@@@@@@@@@@@@@@@@@@@@@@@@@@@@@@@@@@@@@@@@@
@@@@@@@@@T.....................TT@TT@TTTTTT...........TTTT..................................................................TTTT........TT@@@@@@@@@@@@@@@@@@@@@@@@@@@@@@@@@@@@@@@@@@@
@@@@@@@@@T.....................TTTTT@TTTTTT...........TTTT..................................................................TTTT........T@@@@@@@@@@@@@@@@@@@@@@@@@@@@@@@@@@@@@@@@@@@@
@@@@@@@@@T......................TTTT@TTTTTTT...........TTT.............................................................TT..TTTT.........T@@@@@@@@@@@@@@@@@@@@@@@@@@@@@@@@@@@@@@@@@@@@
@@@@@@@@@T.........................TT@TTTTTT.........TTTTTT............................................................TT..TTTT........TT@@@@@@@@@@@@@@@@@@@@@@@@@@@@@@@@@@@@@@@@@@@@
@@@@@@@@@T.........................TT@TTTTTT.........TTTTTT...............................................................TTTT..TTTTTTTTT@@@@@@@@@@@@@@@@@@@@@@@@@@@@@@@@@@@@@@@@@@@@
@@@@@@@@@T.........................TT@TTTTTT..........TTTTT..............................................................TTTT...TTTTTTTT@@@@@@@@@@@@@@@@@@@@@@@@@@@@@@@@@@@@@@@@@@@@@
@@@@@@@@@T.........................TT@TTTTTTT.........TTTTTT.........................T...................................TTTT...TTTTTTTT@@@@@@@@@@@@@@@@@@@@@@@@@@@@@@@@@@@@@@@@@@@@@
TTTTTTTTTT..........................TT@TTTTTT.........TTTTTT.....................TTTTTTT............................T...TTTT....TTTTTTTT@@@@@@@@@@@@@@@@@@@@@@@@@@@@@@@@@@@@@@@@@@@@@
T...................................TT@TTTTTT.........TTTTTT.....................TTTTTTT...........................TTTT.TTTT....TTTTTTT@@@@@@@@@@@@@@@@@@@@@@@@@@@@@@@@@@@@@@@@@@@@@@
T...................................TT@TTTTTT..........TTTTT...................TTTTTT..................TT.........TTTTTTTTT.....TTTTTTT@@@@@@@@@@@@@@@@@@@@@@@@@@@@@@@@@@@@@@@@@@@@@@
T...................................TTTTTTTTTT.........TTTTTT..................TTTTTT..................TT........TTTTTTTTTTTTTTTTTTTTTT@@@@@@@@@@@@@@@@@@@@@@@@@@@@@@@@@@@@@@@@@@@@@@
T.TTTT...............................TT@TTTTTT.........TTTTTT...................TT.T............................TTTTT..TTTTTTTTTTTTTTTT@@@@@@@@@@@@@@@@@@@@@@@@@@@@@@@@@@@@@@@@@@@@@@
T.TTTT............................TT.TT@TTTTTT..........TTTTT..................................................TTTTT...TTTTTTTTTTTTTTT@@@@@@@@@@@@@@@@@@@@@@@@@@@@@@@@@@@@@@@@@@@@@@@
T.TTTT.........................TTTTT.TT@TTTTTTT...........TTTTT................................................TTTT...TTTTTTTTTTTTTTTT@@@@@@@@@@@@@@@@@@@@@@@@@@@@@@@@@@@@@@@@@@@@@@@
T.TTTT.........................TTTTTT@TT@TTTTTT..........TTTTTTT.........................................TTTTT..TT...TTTT@@TTTTTTTTTTT@@@@@@@@@@@@@@@@@@@@@@@@@@@@@@@@@@@@@@@@@@@@@@@
TTTTTT...........................TTTT@TT@TTTTTT..........TTTTTTT......................................TTTTTTTT......TTTT@@@@TTTTTTTTTT@@@@@@@@@@@@@@@@@@@@@@@@@@@@@@@@@@@@@@@@@@@@@@@
TTTTTT...........................TTTTTTT@TTTTTT........TTTTTTTTTTTT...............................TTTTTTTTTTTTTT...TTTT@@@@@@@TTTTTTTT@@@@@@@@@@@@@@@@@@@@@@@@@@@@@@@@@@@@@@@@@@@@@@@
TTT...............................TTTTTT@TTTTTTT......TTTTTTTTTTTTT..............................TTTTTTTTTTTTTTTT.TTTT@@@@@@@@@TTTTTTTTT@@@@@@@@@@@@@@@@@@@@@@@@@@@@@@@@@@@@@@@@@@@@@
TTT...............................TTTT@TT@TTTTTT.....TTTTTTTTTTT...............................TTTTTTTTTTTTTTTTTTTTTT@@@@@@@@@@@@TTTTTTTT@@@@@@@@@@@@@@@@@@@@@@@@@@@@@@@@@@@@@@@@@@@@
TTTTTTT...........................TTTT@TT@TTTT.......TTTTTTTTTTTT..............T...............TTTTTTTTTTTTTTT@@TTTT@@@@@@@@@@@@@TTTTTTTTTT@@@@@@@@@@@@@@@@@@@@@@@@@@@@@@@@@@@@@@@@@@
TTTTTTT...........................TTTTTTT@TT..........TTTTT....TT.............TT...............TTTTTTTTTTTTTTTT@TTT@@@@@@@@@@@@@TTT@@@@@TTTT@@@@@@@@@@@@@@@@@@@@@@@@@@@@@@@@@@@@@@@@@
@TTTTT.............................TTTTTT@TT...TTT....TTT....................TTT.........TTTTT.TTTTTTTTTTTTTTTTTTTT@@@@@@@@@@@@TTT@@@@@@@TTTTT@@@@@@@@@@@@@@@@@@@@@@@@@@@@@@@@@@@@@@@
@TTTTTTT...........................TTTTTTT@TT.TTTT..........................TTT..........TTTTT..TTTTTTTTTTTTTTTTTTTT@@@@@@@@@@TTTTTTT@@@@@TTTTTT@@@@@@@@@@@@@@@@@@@@@@@@@@@@@@@@@@@@@
@@TTTTTT...........................TTTTTTTTTTTTTTTT......................................TTTTTTTTTTTTTTTTTTTTTTTTTTTT@@@@@@@@TTTTTTTTT@@@@T@@TTTTT@@@@@@@@@@@@@@@@@@@@@@@@@@@@@@@@@@@
@@TTTTTT...........................TTTT.TTTTTTTTTTT....................................TTTTTTTTTTTTTTTTTTTTTTTTTTT@TTT@@@@@@TTT.TTTTTTT@@TTT@TTTTTT@@@@@@@@@@@@@@@@@@@@@@@@@@@@@@@@@@
@@@T@TTT................................TTTTTTTTTTT.......................TT............TTTTTTTTTTTTTTTTTTTTTTTTTT@@TTT@@@@TTT...TTTTTTTTTTTTTTTTTTTTT@@@@@@@@@@@@@@@@@@@@@@@@@@@@@@@
@@@T@TTT................................TTTTTTTTTTT......................TTT...........TTTTTTT@TTTTTTTTTTTTTTTTT@@@@@TTT@@TTTT....TTTTTTTTTTTTTTTTTTTTTT@@@@@@@@@@@@@@@@@@@@@@@@@@@@@
@@@@TTTT.......T........................TTTTTTT.TTT.....................TTTTTT........TTTTTTT@@TTTTTTTTTTTTTTTTT@@@@@@TTTTTTTTT....TTTTTTTT@TTTTTTTTTTTTT@@@@@@@@@@@@@@@@@@@@@@@@@@@@
@@@@@T.......TTT........................TTTTTT..........................TTTTTTTTTT...TTTTTTTT@@TTTTTTTTTTTT@@@@@@@@@TTTTTTTTTTTT....TTTTTTTTTTTTTTTTTTTTTT@@@@@@@@@@@@@@@@@@@@@@@@@@@
@@@@@T......TTT..........................TTTT...........................TTTTTTTTTTTTTTTTTTTTTTTTTTTTTTTTT@@@@@@@@@@TTTTTTT@TTTTTT......TTTTTTTTTTTTTTTTTTTT@@@@@@@@@@@@@@@@@@@@@@@@@@
@@@@@@T.....TTT.......................................................TTTTTTTTTTTTTTTTT@TTTTTTTTTTTTTTTTT@@@@@@@@@@TTTTTTT@TTTTTTT......TTTTTTTTTTT@@TT@TTTTT@@@@@@@@@@@@@@@@@@@@@@@@
@@@@@@T....TTTTT.....................................................TTTTTTTTTTTTTTT@@@@@@TTTTTTTTTTTTTT@@@@@@@@TTTTTTTTTT@TTTTTTTT......TTTTTTTTTTTT@@TTTTTTT@@@@@@@@@@@@@@@@@@@@@@@
@@@@@@@T...TTTTTT....................................................TTTTTTTTTTTTTTTT@@@@@@TTTTTTTTTTT@@@@@@@TTTTTTTTTTTTT@@TTTTTT........TTTTTTTTTTTTTTTTTTTTTT@@@@@@@@@@@@@@@@@@@@@
@@@@@@@@T.TTTTTTT.......................................................TTTTTTTTTTTTTTTTT@@TTTTTTTTT@@@@@TTTTTTTTTTTTTTTTT@@@TTTTTT........TTTTTTTT@TTTTTTTTTTTTTT@@@@@@@@@@@@@@@@@@@
@@@@@@@@TTTTTTTTT.......................................................TTTTTTTTTTTTTTTTTTTTTTTTTTT@@TTTTTTTTTTTTTT.TTTTT@@@@@TTTTTT........TTTTTTTTTTTTTTTTTTTTTTTT@@@@@@@@@@@@@@@@@
@@@@@@@@@TTTTTTTT......................................................TTTTTTTT..TTTTTTTTTTTTTTTTTTTTTTTTTTTTTTT......TT@T@@@@TTTTTTT........TTTTTTTTTTTTTTTTTTTTTTTT@@@@@@@@@@@@@@@@
@@@@@@@@@TTTTTTTT......................................................TTTTT.......TTTTTTTTTTTTTTTTTTTTTTTTTTTTT.......TT@T@@TTTTTTTTT........TTTTT@TTTTTTTTTTTTTT.TTTT@@@@@@@@@@@@@@
@@@@@@@@@@TTTTTTTT.TTT................................................TTTTTT.......TTTTTTTTTTTTTTTTTTTTTTTTTT..........TT@TTTTTTTTTTTTT........TTTTT@@TTTTTT.TTTT....TTTT@@@@@@@@@@@@
@@@@@@@@@@TTTTTTTTTTTT..................................................TTT..........TT.....TTTTTTTTT.TTT.TT............TT@TTTTTTTTTTTTT........TTTTT@TTTTT..........TTTTTT@@@@@@@@@@
@@@@@@@@@@@TTTTTTTTTTT...................................T........T.........................TTTTTTTT..TT................TT@TTTTTTTTTTTTTT........TTTTTTTTTT..........TTTTTTT@@@@@@@@@
@@@@@@@@@@@@TTTTTTTTTT...................................TTTT..................................TTTT......................TT@TTTTTTTTTTTTTT........TTTTTTTTT..........TTTTTTTTT@@@@@@@
@@@@@@@@@@@@TTTTTTTTTTT................................TTTTT........T....................................................TTTTTTT@TTTTTTTTTT........TTTTTTTT............TTTTTTTTT@@@@@
@@@@@@@@@@@@@TTTTTTTTTT................................TT....TT....TTTT...................................................TT@TT@TTTT@TTTTTTT.........TTTTTTT............TTTTTTTTTTT@@
@@@@@@@@@@@@@TTTTTTTTTTT.................................TTTTTTTT.TTTTT....................................................TT@TTTTTTTTTTTTTTT.........TTTTTT..............TTTTTTTTTTT
@@@@@@@@@@@@@@TTTTTTTTTTT................................TTTTTTTTTTTTTTTTT.................................................TTTTTTTTTTTTTTTTTTT........TTTTTT..................TTTTTT@
@@@@@@@@@@@@@@@TTTTTTTTTT.................................TTTTTTTTTTTTTTTTTTTT.........................................TTTTTTTTTTTTTTTTT.TTTTTT........TTTTT..................TTTTT@@
@@@@@@@@@@@@@@@TTTTTTTTTTT................................TTTTTTTTTTTTTTTTTTTTTTTT......................................TTTTTTTTTTTTTTT...TTTTT........TTTTT..................TTTTT@@
@@@@@@@@@@@@@@@@TTTTTTTTTT................................TTTTTTTTTTTTTTTTTTTTTTTTTTTT........................TT........TTTTTTTTTTTTTT.....TTTT........TTTTT..................TTTT@@@
@@@@@@@@@@@@@@@@T..TTTTTTTT...............................TTTTTTTTTTTTTTTTTTTTTTTTTTTTTTT....................TTTT.......TTTTTTTTTTTTT.......TT.........TTTTT..................TTTT@@@
@@@@@@@@@@@@@@@@@T..TTTTTT.................................TTTTTTTTTTTTTTTTTTTTTTTTTTTTTTTTT...........TTTTT.TTTT....TTTTTTTTTTTTTTT...................TTTTT....................T@@@@
@@@@@@@@@@@@@@@@@T..TTTT....................................TTTTTTTTT@@@@TTTTTTTTTTTTTTTTTTTTT...TT...TTTTTT..TTTTTTTTTTTTTTTTTTTTTTTT.................TTTTT....................T@@@@
@@@@@@@@@@@@@@@@@@T.TTT........TT..............................TTTTTTTTTT@@@TTTTTTTTTTTTTTTTTT...TTT.TTTTT....TTTTTTTTTTTTTTTTTTTTTTTT...............TTTTTTTT..................T@@@@@
@@@@@@@@@@@@@@@@@@T...........TTTT..............................TTTT@TTTTTTT@@@@TTTTTTTTTTTTTTT..TTT.TTTT@TTTTTTT@TTTTTTTTTTTTTTTTTTT@T..............TTTTTTTT.................T@@@@@@
@@@@@@@@@@@@@@@@@@@T..........TTTT................................TTTTT..TTTTTTT@@@@TTTTTTTTTTT.......TTTTTTT@@@@TTTTTTTTTTTTTTTTTTTTTTTT..............TTTTTT.................T@@@@@@
@@@@@@@@@@@@@@@@@@@@T..TTTT....TTT.TT.............................TTTTT.....TTTTTTTT@@@@TTTTTTTTTTTTTTTTT@@@@TTTTTTTTTTTTTTTTTTTTTTTTTTTTT.............TTTTTT................T@@@@@@@
@@@@@@@@@@@@@@@@@@@@T..TTTT........TT.............................TTTTT.........TTTTTTTT@@@TTTTTTTTTTT@@@TTTTTTTT@TTTTTTTTTTTTTTTTTTTTTTTT..............TTTTT................T@@@@@@@
@@@@@@@@@@@@@@@@@@@@@T.TTTT..TT...................................................TTTTTTTTT@@@TTTTTTT@TTTTTTT@@@@TTTTTTTTTTTTTTTTTTTTTTTTTT.............TT..................T@@@@@@@@
@@@@@@@@@@@@@@@@@@@@@T.TTTT.TTT.TT................................................TTTTTTTTTTTTTTTTTTTTTTTT...TTTTTTTTTTTTTTT..TTTTTTTTTTTTT.................................T@@@@@@@@
@@@@@@@@@@@@@@@@@@@@@@TTTTTTTT.TTT....TT.............................................TTTTTTTTTTTTTTTTT.......TTTTTTTTTTTTTTT..TTTTTTTTTTTTT................................T@@@@@@@@@
@@@@@@@@@@@@@@@@@@@@@@TT....T..TTTT.TTTTT.............................................TTTTT..TTTTTTT..........TTTTTTTTTTTTTT...TTTTTTTTTT..............................TT.T@@@@@@@@@@
@@@@@@@@@@@@@@@@@@@@@@@TT.......TTT.TTTTT..............................................TTTT..TTTTTT..TT.......TTTTTTTTTTTTT....TTTTTTTTTTT............................TTTTT@@@@@@@@@@
@@@@@@@@@@@@@@@@@@@@@@@@TTTT....TTTTTTTT................................................TTT...TTT.....T.......TTTTTTTTT.........TTTTTTTTTT............................TTTT@@@@@@@@@@@
@@@@@@@@@@@@@@@@@@@@@@@@TTTTT...TTTTTTT.......................................................TTT..............TTTT.............TTTT.TTTT.............................TTTT@@@@@@@@@@@
@@@@@@@@@@@@@@@@@@@@@@@@@TTTTT...TT.TT.......................................................TTT.................................T....T................................TT@@@@@@@@@@@@
@@@@@@@@@@@@@@@@@@@@@@@@@TT@TTT..T...........................................................TTT......................................................................TTT@@@@@@@@@@@@
@@@@@@@@@@@@@@@@@@@@@@@@@@TTTTT...............................................................TT.................................................................TTTTTTT@@@@@@@@@@@@@
@@@@@@@@@@@@@@@@@@@@@@@@@@@TTTT...........TTT.............................................................................................TTT..................TTTTTTTT@@@@@@@@@@@@@@
@@@@@@@@@@@@@@@@@@@@@@@@@@@@@TTT.........TTTTT...........................................................................................TTTTTTTT.............TTTTTTT@@@@@@@@@@@@@@@@
@@@@@@@@@@@@@@@@@@@@@@@@@@@@@@@T........TTTTTTT..........................................................................................TTTTTTTTT...........TTT@@T@@@@@@@@@@@@@@@@@@
@@@@@@@@@@@@@@@@@@@@@@@@@@@@@@@@TT......TTTTTTT..............................................T...........................................TTTTTTTT...........TTTTTT@@@@@@@@@@@@@@@@@@@
@@@@@@@@@@@@@@@@@@@@@@@@@@@@@@@@@@TT.....TTTTT..............................................TTTTTTTT...................................TTTTTTTTT...........TTTTT@@@@@@@@@@@@@@@@@@@@@
@@@@@@@@@@@@@@@@@@@@@@@@@@@@@@@@@@@@TT..TTTT....................TTT..........................TTTTTTT.................................TTTTTTTTTTT........TTT@TT@@@@@@@@@@@@@@@@@@@@@@@
@@@@@@@@@@@@@@@@@@@@@@@@@@@@@@@@@@@@@@T..T@TTT................TTTTT..........................TTTTTTT.................................TTTTTTTTTTTT.......TTTT@@@@@@@@@@@@@@@@@@@@@@@@@
@@@@@@@@@@@@@@@@@@@@@@@@@@@@@@@@@@@@@@@TT@TTTT................TTTTT.........................TTTTTTTT.................................TTTTTTTTTTTTTTTTTTTTTT@@@@@@@@@@@@@@@@@@@@@@@@@@
@@@@@@@@@@@@@@@@@@@@@@@@@@@@@@@@@@@@@@@@@TTTTT.TT.............TTTT..........................TTTTTTTT.................................TTTTTTTTTTTTTTTTTTTT@@@@@@@@@@@@@@@@@@@@@@@@@@@@
@@@@@@@@@@@@@@@@@@@@@@@@@@@@@@@@@@@@@@@@@@@TT@TTTTTT...........TTT....................................................................TTTTTTTTTTTTTTTTT@@@@@@@@@@@@@@@@@@@@@@@@@@@@@@
@@@@@@@@@@@@@@@@@@@@@@@@@@@@@@@@@@@@@@@@@@@@@TTTTTTTTT.........TTT...................................................................TTTTTTTTTTTTTTTT@@@@@@@@@@@@@@@@@@@@@@@@@@@@@@@@
@@@@@@@@@@@@@@@@@@@@@@@@@@@@@@@@@@@@@@@@@@@@@@TTTTTTTTTT..............................................................................TTTTTTTTTTTTTT@@@@@@@@@@@@@@@@@@@@@@@@@@@@@@@@@
@@@@@@@@@@@@@@@@@@@@@@@@@@@@@@@@@@@@@@@@@@@@@@@@TTTTTTTTTT.........................................................................TT..TTTTTTTTTTT@@@@@@@@@@@@@@@@@@@@@@@@@@@@@@@@@@@
@@@@@@@@@@@@@@@@@@@@@@@@@@@@@@@@@@@@@@@@@@@@@@@@@@TTTTTTTTT......................................................................TTTTT...TTTTTTT@@@@@@@@@@@@@@@@@@@@@@@@@@@@@@@@@@@@@
@@@@@@@@@@@@@@@@@@@@@@@@@@@@@@@@@@@@@@@@@@@@@@@@@@@@TTTTTTTTT........................TT.........................................TTTTTTTTTTTTTT@@@@@@@@@@@@@@@@@@@@@@@@@@@@@@@@@@@@@@@
@@@@@@@@@@@@@@@@@@@@@@@@@@@@@@@@@@@@@@@@@@@@@@@@@@@@@TTTTTTTTTT.....................TTT.............................TT..........TTTTTTTTTTTTT@@@@@@@@@@@@@@@@@@@@@@@@@@@@@@@@@@@@@@@@
@@@@@@@@@@@@@@@@@@@@@@@@@@@@@@@@@@@@@@@@@@@@@@@@@@@@@@@TTTTTTTTTT...................TTT.............................TT.T..TTTTTTTTTTTTTTTTT@@@@@@@@@@@@@@@@@@@@@@@@@@@@@@@@@@@@@@@@@@
@@@@@@@@@@@@@@@@@@@@@@@@@@@@@@@@@@@@@@@@@@@@@@@@@@@@@@@@@TTTTTTTTT..................TTTTT......TTTTTTTTTTTTT........TTTTT.TTTTTTTTTTTTTTT@@@@@@@@@@@@@@@@@@@@@@@@@@@@@@@@@@@@@@@@@@@@
@@@@@@@@@@@@@@@@@@@@@@@@@@@@@@@@@@@@@@@@@@@@@@@@@@@@@@@@@@TTTTTTTTTT...............TTTTTTT.....TTTTTTTTTTTTT.........TTTT.TTTTTTT.TTTTT@@@@@@@@@@@@@@@@@@@@@@@@@@@@@@@@@@@@@@@@@@@@@@
@@@@@@@@@@@@@@@@@@@@@@@@@@@@@@@@@@@@@@@@@@@@@@@@@@@@@@@@@@@@TTTTTTTTTT.............TTTTTTTTTTTTTTTTTTTTTTTTT.........TT...TTT.....TTTT@@@@@@@@@@@@@@@@@@@@@@@@@@@@@@@@@@@@@@@@@@@@@@@
@@@@@@@@@@@@@@@@@@@@@@@@@@@@@@@@@@@@@@@@@@@@@@@@@@@@@@@@@@@@@@TTTTTTTTTTT...........TTTTTTTTTTTTTTTTTTTTTTTT......................TT@@@@@@@@@@@@@@@@@@@@@@@@@@@@@@@@@@@@@@@@@@@@@@@@@
@@@@@@@@@@@@@@@@@@@@@@@@@@@@@@@@@@@@@@@@@@@@@@@@@@@@@@@@@@@@@@@@TTTTTTTTTT..........TTTTTTTTTTTTTTTTTTTTTTTT.....................T@@@@@@@@@@@@@@@@@@@@@@@@@@@@@@@@@@@@@@@@@@@@@@@@@@@
@@@@@@@@@@@@@@@@@@@@@@@@@@@@@@@@@@@@@@@@@@@@@@@@@@@@@@@@@@@@@@@@@TTTTTTTTTTTTT......TTTTTTTTTTTTTTTTTTTTTTTT...............TTTTTT@@@@@@@@@@@@@@@@@@@@@@@@@@@@@@@@@@@@@@@@@@@@@@@@@@@@
@@@@@@@@@@@@@@@@@@@@@@@@@@@@@@@@@@@@@@@@@@@@@@@@@@@@@@@@@@@@@@@@@@@TTTTTTTTTTTT.....TTTTTTTTTTTTTTTTTTT................TT..TTTT@@@@@@@@@@@@@@@@@@@@@@@@@@@@@@@@@@@@@@@@@@@@@@@@@@@@@@
@@@@@@@@@@@@@@@@@@@@@@@@@@@@@@@@@@@@@@@@@@@@@@@@@@@@@@@@@@@@@@@@@@@@@TTTTTTTTTT........TTTTTTTTTTTTTTTT..............TTTTTTTT@@@@@@@@@@@@@@@@@@@@@@@@@@@@@@@@@@@@@@@@@@@@@@@@@@@@@@@@
@@@@@@@@@@@@@@@@@@@@@@@@@@@@@@@@@@@@@@@@@@@@@@@@@@@@@@@@@@@@@@@@@@@@@@TTTTTTTTTTTTTTTTTTTTTTTTTTTTTTTTTTTTTTTTTTTTTTTTTTTTT@@@@@@@@@@@@@@@@@@@@@@@@@@@@@@@@@@@@@@@@@@@@@@@@@@@@@@@@@@
