type octile
height 32
width 49
map
.................................................
.................................................
.................................................
.................................................
.................................................
.................................................
.................................................
.................................................
.................................................
.................................................
.................................................
.................................................
.................................................
.................................................
.................................................
.................................................
.................................................
.................................................
.................................................
.................................................
@................................................
@................................................
@................................................
@................................................
@................................................
@................................................
@................................................
@................................................
@................................................
@................................................
@................................................
@................................................
