type octile
height 20
width 20
map
......@@..........@@
......@@..........@@
..@@@@@@..@@@@@@..@@
..@@@@@@..@@@@@@..@@
..@@..........@@..@@
..@@..........@@..@@
..@@@@@@@@@@..@@@@@@
..@@@@@@@@@@..@@@@@@
..@@..............@@
..@@..............@@
..@@@@@@@@@@@@@@..@@
..@@@@@@@@@@@@@@..@@
..................@@
..................@@
@@@@@@@@@@@@@@@@..@@
@@@@@@@@@@@@@@@@..@@
..................@@
..................@@
@@@@@@@@@@@@@@@@@@@@
@@@@@@@@@@@@@@@@@@@@
