type octile-corner
height 97
width 97
map
2222222222222222222222222222222222222222222222222222222222222222222222222222222222222222222222222
2222222222222222222222222222222222222222222222222222222222222222222222222222222222222222222222222
2222222222222222222222222222222222222222222222222222222222222222222222222222222222222222222222222
2222222222222222222222222222222222222222222222222222222222222222222222222222222222222222222222222
2222222222222222222222222222222222222222222222222222222222222222222222222222222222222222222222222
2222222222222222222222222222222222222222222222222222222222222222222222222222222222222222222222222
2222222222222222222222222222222222222222222222222222222222222222222222222222222222222222222222222
2222222222222222222222222222222222222222222222222222222222222222222222222222222222222222222222222
2222222222222222222222222222222222222222222222222222222222222222222222222222222222222222222222222
2222222222222222222222222222222222222222222222222222222222222222222222222222222222222222222222222
2222222222222222222222222222222222222222222222222222222222222222222222222222222222222222222222222
2222222222222222222222222222222222222222222222222222222222222222222222222222222222222222222222222
2222222222222222222222222222222222222222222223322222222222222222222222222222222222222222222222222
2222222222222222222222222222222222222222322323333222222222222322222222222222222222222222222222222
2222222222222222222222222222222222233232333333333332233232223332222222222222222222222222222222222
2222222222222222222222222222222222233333333333333333333333333332222222222222222222222222222222222
2222222222222222222222222222222222333333333333333333333333333322222222222222222222222222222222222
2222222222222222222222222222222222233333333333333333333333333322222222222222222222222222222222222
2222222222222222222222222222222222233333333333333333333333333222222222222222222222222222222222222
2222222222222222222222222222222222223333333333333322233333333332222222222222222222222222222222222
2222222222222222222222222222222222222333333333222222223333333322222222222222222222222222222222222
2222222222222222222222222222222222222233333223222222223333333332222222222222222222222222222222222
2222222222222222222222222222222222222233333222222222223333333332222222222222222222222222222222222
2222222222222222222222222222222222222223332222222222222333333332222222222222222222222222222222222
2222222222222222222222222222222222222233332222222222222333333332222222222222222222222222222222222
2222222222222222222222222222222222222233333222222222222333333332222222222222222222222222222222222
2222222222222222222222222222222222222223333222222222223333333332222222222222222222222222222222222
2222222222222222222222222222222222222223232222222222223332222222222222222222222222222222222222222
2222222222222222222222222222222222222222222222222222223222222222222222222222222222222222222222222
2222222222222222222222222222222222222222222222222222222222222222222222222222222222222222222222222
2222222222222222222222222222222222222222222222222222222222222222222222222222222222222222222222222
2222222222222222222222222222222222222222222222222222222222222222222222222222222222222222222222222
2222222222222332222222222222222222222222222222222222222222222222222222222222222222222222222222222
2222222222223333332222222222222222222222222222222222222222222222222222222222222222222222222222222
2222222222223333333322222222222222222222222222222222222222222222222222222222222222222222222222222
2222222222223333333322222222222222222222222222222222222222222222222222223333332222222222222222222
2222222222223333333333322222222222222222222222222222222222222222222222223333332222233222222222222
2222222222223333333333322222222222222222222222222222222222222222222222233333333223333322222222222
2222222222223333333333322222222222222222222222222222222222222222222222223333333333333322222222222
2222222222222333333333333322222222222222222332222222222222222222222222233333333333333322222222222
2222222222223333333333333322222222222222223332222223332222222222222222222333333333333322222222222
2222222222223333333333333322222222222222333332222223332222222222222222223333333333333322222222222
2222222222223333333323333322222222222223333332222223332222222222222222223333333333333322222222222
2222222222223333332222232222222222222223333333333333333322222222222222222332233333333332222222222
2222222222222333332222222222222222222233333333333333333333222222222222222222233333333322222222222
2222222222222333332222222222222222222222333333333333333333322222222222222222223333333322222222222
2222222222223333322222222222222222222222233333333333333332222222222222222222223333333322222222222
2222222222223333322222222222222222222222233333333333333322222222222222222222223333333322222222222
2222222222223333332222222222222222222222233333333333333332222222222222222222222333333322222222222
2222222222223333332222222222222222222222223333333333333332222222222222222222223333333322222222222
2222222222223333333222222222222222222222233333333333333332222222222222222222223333333322222222222
2222222222222333333322222222222222222223333333333333333322222222222222222222233333333322222222222
2222222222223333333322222222222222222223333333333333333322222222222222222222233333333332222222222
2222222222223333333332222222222222222233333333333333333322233222222222222222233333333332222222222
2222222222223333333332232222222222222223332333333333333333333322222222222232233333333322222222222
2222222222223333333333333322222222222222222233333333333333333322222222222333333333333332222222222
2222222222233333333333333322222222222222222223333333333333333222222222222333333333333322222222222
2222222222233333333333333222222222222222222223333333333333322222222222222333333333333332222222222
2222222222223333333333333322222222222222222233333333333333322222222222222333333333333332222222222
2222222222223333333333333222222222222222222332222222333332222222222222222333333333333332222222222
2222222222233333333333332222222222222222222332222222333222222222222222222333333333333332222222222
2222222222222332233222222222222222222222223332222222333222222222222222222333333333333322222222222
2222222222222222222222222222222222222222222232222222332222222222222222222232332233333322222222222
2222222222222222222222222222222222222222222222222222222222222222222222222222322233333222222222222
2222222222222222222222222222222222222222222222222222222222222222222222222222222223333222222222222
2222222222222222222222222222222222222222222222222222222222222222222222222222222223232222222222222
2222222222222222222222222222222222222222222222222222222222222222222222222222222222222222222222222
2222222222222222222222222222222222222222222222222222222222222222222222222222222222222222222222222
2222222222222222222222222222222222222222222222222222222222222222222222222222222222222222222222222
2222222222222222222222222222222222222222222222222222222222222222222222222222222222222222222222222
2222222222222222222222222222222222222222222222222222222222222222222222222222222222222222222222222
2222222222222222222222222222222222222222222222222222222222222222222222222222222222222222222222222
2222222222222222222222222222222222222222222222222222222222222222222222222222222222222222222222222
2222222222222222222222222222222222222222222222222222222222222222222222222222222222222222222222222
2222222222222222222222222222222222222232233222222222222222222222222222222222222222222222222222222
2222222222222222222222222222222222233333333222222222222222332222222222222222222222222222222222222
2222222222222222222222222222222222233333332222222222222222333222222222222222222222222222222222222
2222222222222222222222222222222222233333332222222222222222233222222222222222222222222222222222222
2222222222222222222222222222222222233333332233222222222322233222222222222222222222222222222222222
2222222222222222222222222222222222233333333333333323332333333322222222222222222222222222222222222
2222222222222222222222222222222222233333333333333333333333333322222222222222222222222222222222222
2222222222222222222222222222222222233333333333333333333333333332222222222222222222222222222222222
2222222222222222222222222222222223333333333333333333333332333333322222222222222222222222222222222
2222222222222222222222222222222223333222222223332322223322223333322222222222222222222222222222222
2222222222222222222222222222222222222222222222222222222222222233322222222222222222222222222222222
2222222222222222222222222222222222222222222222222222222222222222222222222222222222222222222222222
2222222222222222222222222222222222222222222222222222222222222222222222222222222222222222222222222
2222222222222222222222222222222222222222222222222222222222222222222222222222222222222222222222222
2222222222222222222222222222222222222222222222222222222222222222222222222222222222222222222222222
2222222222222222222222222222222222222222222222222222222222222222222222222222222222222222222222222
2222222222222222222222222222222222222222222222222222222222222222222222222222222222222222222222222
2222222222222222222222222222222222222222222222222222222222222222222222222222222222222222222222222
2222222222222222222222222222222222222222222222222222222222222222222222222222222222222222222222222
2222222222222222222222222222222222222222222222222222222222222222222222222222222222222222222222222
2222222222222222222222222222222222222222222222222222222222222222222222222222222222222222222222222
2222222222222222222222222222222222222222222222222222222222222222222222222222222222222222222222222
2222222222222222222222222222222222222222222222222222222222222222222222222222222222222222222222222
OOOOOOOOOOOOOOOOOGOOOOOOOOOOOOOOOOOOOOOOOOOOOOOOOOOOOOOOOOOOOOOOOOOOOOOOOOOOOOOOOOOOOOOOOOOOOOOOO
OOOOOOOOOOOOOOOOOOOOOOOOOOOOOOOOOOOOOOOOOOOOOOOOOOOOOOOOOOOOOOOOOOOOOOOOOOOOOOOOOOOOOOOOOOOOOOOOO
OOOOOOOOOOOOOOOOOOOOOOOOOOOOOOOOOOOOOOOOOOOOOOOOOOOOOOOOOOOOOOOOOOOOOOOOOOOOOOOOOOOOOOOOOOOOOOOOO
OOOOOOOOOOOOOOOOOOOOOOOOOOOOOOOOOOOOOOOOOOOOOOOOOOOOOOOOOOOOOOOOOOOOOOOOOOOOOOOOOOOOOOOOOOOOOOOOO
OOOOOOOOOOOOOOOOOOOOOOOOOOOOOOOOOOOOOOOOOOOOOOOOOOOOOOOOOOOOOOOOOOOOOOOOOOOOOOOOOOOOOOOOOOOOOOOOO
OOOOOOOOOOOOOOOOOOOOOOOOOOOOOOOOOOOOOOOOOOOOOOOOOOOOOOOOOOOOOOOOOOOOOOOOOOOOOOOOOOOOOOOOOOOOOOOOO
OOOOOOOOOOOOOOOOOOOOOOOOOOOOOOOOOOOOOOOOOOOOOOOOOOOOOOOOOOOOOOOOOOOOOOOOOOOOOOOOOOOOOOOOOOOOOOOOO
OOOOOOOOOOOOOOOOOOOOOOOOOOOOOOOOOOOOOOOOOOOOOOOOOOOOOOOOOOOOOOOOOOOOOOOOOOOOOOOOOOOOOOOOOOOOOOOOO
OOOOOOOOOOOOOOOOOOOOOOOOOOOOOOOOOOOOOOOOOOOOOOOOOOOOOOOOOOOOOOOOOOOOOOOOOOOOOOOOOOOOOOOOOOOOOOOOO
OOOOOOOOOOOOOOOOOOOOOOOOOOOOOOOOOOOOOOOOOOOOOOOOOOOOOOOOOOOOOOOOOOOOOOOOOOOOOOOOOOOOOOOOOOOOOOOOO
OOOOOOOOOOOOOOOOOOOOOOOOOOOOOOOOOOOOOOOTTTTTTOOOOOOOOOOOOOOOOOOOOOOOOOOOOOOOOOOOOOOOOOOOOOOOOOOOO
OOOOOOOOOOOOOOOOOOOOOOOOOOOOOOOOOOOOOOOTTTTTOTTTTTOOOOOOOOOOOOOOOOOOOOOOOOOOOOOOOOOOOOOOOOOOOOOOO
OOOOOOOOOOOOOOOOOOOOOOOOOOTTTTTTTTTTTTTOOOOOOOOTTTTTTTOOTTTTTTTTTOOOOOOOOOOOOOOOOOOOOOOOOOOOOOOOO
OOOOOOOOOOOOOOTTTTOOOOOOOOTTTTTTTTTOOOOOOOOOOOOOOOTTTTTOOOOOOOTTTOTOOTTTOOTOOOOTOOOOOOOOOOOOOOOOO
OOOOOOOOOOOOOOTTTTTTTTTTTTTTTTTTTTOOOOOOOOOOOOOOOOOOOOOOOOOOOOOTTTTTTTTTOTTTTTTTTTOOOOOOOOOOOOOOO
OOOOOOOOOOOOOOTTTTTTTTTTTTTTTTTTTOOOOOOOOOOOOOOOOOOOOOOOOOOOOOOTTTTTTOOOOTOTTTTTTTOOOOOOOOOOOOOOO
OOOOOOOOOOOOOOOTTTTTTTTTTTTTTTTTTOOOTOTOOOOOTTTTTTTTTTOOOOTOOOOTTTTTTTTTTTTTTTTTTOOOOOOOOOOOOOOOO
OOOOOOOOOOOOOOOTTTTTTTTTTTTTTTTTTOOOTTTTOTTTTTTTTTTTTTTTTTTOOOOTTTTTTTTTTTTTTTTTTOOOOOOOOOOOOOOOO
OOOOOOOOOOOOOOOTTTTTTTTTTTTTTTTTTGGGGTGGTTTTGTGGTTTGGGTTTTGGGGTGTGGGGTTTTTTTTTTTTOOOOOOOOOOOOOOOO
OOOOOOOOOOOOOOOTTTTTTTTTTTTTTTTTTTGGTTTTTTTGTGTTTGGGGTTTTTTTGGGTTTTTTTTTTTTTTTTTTOOOOOOOOOOOOOOOO
OOOOOOOOOOOOOOOTTTTTTTTTTGTTTTTTTTGGGTTGTTTTTGGGGGGGGGTTTTGTTGGTTTTTTTTTTTTTTTTTTOOOOOOOOOOOOOOOO
OOOOOOOOOOOOOOOTTTTTGGGGGGTTTTTTTTTGGGTTTTGGGGGGGGGGGGTTTTTTTGGTTTTTTTTTTTTTTTTTTOOOOOOOOOOOOOOOG
OOOOOOOOOOOOOOOTTTTTGGGGGGGTTTTTTTTTTGTTGTGGGGGGGGGGGGTTGTTGTTGTTTTTTTTTGGGGTTOOOOOOOOOOOOOOOOOOG
OOOOOOOOOOOOOOOTTTGTGGGGGGGGTTTTTTTTTGGGGGGGGGGGGGGGGGGTTGGGGTGTTTTTTTGGGGGGTTTTTOOOOOOOOOOOOOOOG
OOOOOOOOOOOOOOOTTTTTGGGGGGGGTTTTTTTTTGGGTGGGGGGGGGGGGGGTTTGGGGgggTGTTGGGGGGGGTTTTOOOOOOOOOOOOOOOO
OOOOOOOOOOOOOOOTTTTTGGGGGGGGGTTTTTTTTGTTTGGTGGGGGGGGGGGTTGGGGGgggGGGGGGGGGGGTTOTTOOOOOOOOOOOOOOOO
OOOOOOOOOOOOOOTTTTTGGGGGGGGGGGTGTTTTTGGTTTGTTGGGGGGGGGGTTGGGgggggGGGGGGGGGGTTTOTTOOOOOOOOOOOOOOOO
OOOOOOOOOOOOOOOTTTTGGGGGGGGGGGGGGGGTTTGGGGGTTGGGGGGGGGTTGGGGgggggGGGGGGGGGTTTTOTTOOOOOOOOOOOOOOOG
OOOOOOOOOOOOOOOTTTTGGGGGGGGGGGGGGGGGTTGGGGTTGGGGGGGGGGGGGGGGgggggGGGGGGGGGTTTTOTTTOOOOOOOOOOOOOOG
OOOOOOOOOOOOOOOTTTTTGGGGGGGGGGGGGGGGGGGGGGGGGGGGGGGGGGGGGGGGGGTGGGGGGGGGGGTTTTOTTTOOOOOOOOOOOOOOO
OOOOOOOOOOOOOOTTTTTTTGGGGGGGGGGGGGGGGGGGGGGGGGGGGGGGGGGGGGGGGTTGGGGGGGGGGTTTTTOTTOOOOOOOOOOOOOOOO
OOOOOOOOOOOOOOTTTTTTTGGGGGGGGGGGGGGGGGGGGGGGGGGGGGGGGGGGGGGGGTGGGGGGGGGGGTTTTTOOOOOOOOOOOOOOOOOOO
OOOOOOOOOOOOOOOOGGTTTGGGGGGGGGGGGGGGGGGGGGGGGGGGGGGGGGGGGGGGGGGGGGGGGGGGGGGTTTTTTOOOOOOOOOOOOOOOO
OOOOOOOOOOOOOOOOGGTTTTGGGGGGGGGGGGGGGGGGGGGGGGGGGGGGGGGGGGGGGGGGGGGGGGgggggttTTTTOOOOOOOOOOOOOOOO
OOOOOOOOOOOOOOOOGGGGTTGGGGGGGGGGGGGGGGGGGGGGGGGGGGGGGGGGGGGGGGGGGGGGGGgggggggTTTTOOOOOOOOOOOOOOOO
OOOOOOOOOOOOOOOTTTGGTTTGGGGGGGGGGGGGGGGGGGGGGGGGGGGGGGGGGGGGGGGGGGGGTGgggggggGTTTOOOOOOOOOOOOOOOO
OOOOOOOOOOOOOOOTTTTGGGgggGGGGGGGGGGGGGGGGGGGGGGGGGGGGGGGGGGGGGGGGGGTTTGGGGGGGGTTTOOOOOOOOOOOOOOOO
OOOOOOOOOOOOOOOTTTTTTTggggggGGGGGGGGGGGGGGGGGGGGGGGGGGGGGGGGGGGGGGGGTTGGGGGGGGOOOOOOOOOOOOOOOOOOO
OOOOOOOOOOOOOOOTTTGGGGggggggGGGGGGGGGGGGGGGGGGGGGGGGGGGGGGGGGGGGGGGGTGGGGGGTTTOOOOOOOOOOOOOOOOOOO
OOOOOOOOOOOOOOOTTTGGGGggggggGGGGGGGGTGGGGGGGGGGGGGGGGGGGGGGGGGGGGGGGGGGGTGTTTTTOOOOOOOOOOOOOOOOOO
OOOOOOOOOOOOOOOTTTGGGGGGGgggGGGGGGGTTTGGGGGTgggGGgggGGTGGGGGGGGGGGGGGGGGGTGTTTOTTOOOOOOOOOOOOOOOO
OOOOOOOOOOOOOOOOGGTTTGTGGgttGGGGGGGTTGGGGGTTggggggggTGGGGGGGGGGGGGGGGGGGGTTTTGTTTOOOOOOOOOOOOOOOO
OOOOOOOOOOOOOOOTTTTGGTTTTGGTGGGGGGGGGGGGTTTTgggggggtTGGGGGGGGGGGGGGGGGGGTTTTTTOTTOOOOOOOOOOOOOOOO
OOOOOOOOOOOOOOOOTGGGGGGGGGGGGGGGGGGGGGGTTTTTgggggggtTGGGGGTTGGGGGGGGGGGGGTGGGTOTTOOOOOOOOOOOOOOOO
OOOOOOOOOOOOOOOOTGGGGGGGGGGGGGGGGGGGGGGTTTTTTGGGGGGTTTGGGGTGGGGGGGGGGGGGGGGGGTOTTOOOOOOOOOOOOOOOO
OOOOOOOOOOOOOOTTGGGGGGGGGGGGGGGGGGGGGGGGTTTTTTGGGGGTTTTGGGGGGGGGGGGGGGGGGGGGGGTTTOOOOOOOOOOOOOOOO
OOOOOOOOOOOOOOTTGGGGGGGGGGGGGGGGGGGGGGGGGTTTTTTGGGGGTTTTGGGGGGGGGGGGGGGGGGGGGGTTTOOOOOOOOOOOOOOOO
OOOOOOOOOOOOOOTTGGGGGGGGGGGGGGGGGGGGGGGGGTTTTTTGGGGTTTTGGGGGGGGGGGGGGGGGGGGGGGTTTOOOOOOOOOOOOOOOO
OOOOOOOOOOOOOOOOGGGGGGGGGGGGGGGGGGGGGGGGGTTTTTGGGGGGGTTGGGGGGGGGGGGGGGGGGGGGGGOOOOOOOOOOOOOOOOOOO
OOOOOOOOOOOOOOTTTGGGGGGGGGGGGGGGGGGGGGGGGGTTTGGGGGGGTTTGGGGGGGGGGGGGGGGGGGGGGGOTTOOOOOOOOOOOOOOOO
OOOOOOOOOOOOOOTTTGGGGGGGGGGGGGGGGGGGGGGGGGTTTGGGGGGGTTTTGGGGGGGGGGGGGGGGGGGGGGTTTOOOOOOOOOOOOOOOO
OOOOOOOOOOOOOOTTGTGGGGGGGGGGGGGGGGGGGGGGGTTTGGGGGGGGGTTGGGGGGGGGGGGGGGGGTGGGGGTTTOOOOOOOOOOOOOOOO
OOOOOOOOOOOOOOTTTGTGGGGGGGGGGGGGGGGGGGGGTTTTTGGGGGGGTTTGGGGGGGGGGGGGGGGGTTTTGTTTTOOOOOOOOOOOOOOOO
OOOOOOOOOOOOOTTTGTTGGGGGGGGGGGGGGGGGGGGGTTTTTTGGGGGGTTTGGGGGGGGGGGGGGGGTTTTTGTTTTOOOOOOOOOOOOOOOO
OOOOOOOOOOOOOTTTGTTTGGGGGGGGGGGGGGGTTGGTTGGTTTGGGGGGTTTGGGGGGGGGGGGGGGGTTGGTGTOTTOOOOOOOOOOOOOOOO
OOOOOOOOOOOOOTTTTGTTGGGGGGGGGGGGGGTTTTGGGGGGTTTGGGGGTTTTGGTTTGGGGGGGGGGgggGGGTOTTOOOOOOOOOOOOOOOO
OOOOOOOOOOOOOOOOTTTTTTTTTGGGGGGGGGTTTTTGGGGGGTTGGGGTTTTTTTTTGGGGGGGGGGGgttTTTTTTTOOOOOOOOOOOOOOOO
OOOOOOOOOOOOOOOOTTTGGTTTGGGGGGGGGGGTTTTGGGGTGTTGGGGGTTTTTTGGGGGGGGGGGGGgggTTTTTTTOOOOOOOOOOOOOOOO
OOOOOOOOOOOOOOOTTTTGGGGTGGGGGGGGGGGGGGGGGGGGgtggggggtTTTTGGGGGGGGGGGGGGgggGGGTTTTOOOOOOOOOOOOOOOO
OOOOOOOOOOOOOOOTGTTTGGGGGGGGGGGGGGGGGGGGGGGGttggggggtTTTGGGGGGGGGGGGGGGgggGGGTTTTOOOOOOOOOOOOOOOO
OOOOOOOOOOOOOOOTTTGGggggGTTGGGGGGGGGGGGGGGGTttggggggtTGGGTTGGGGGGGGGGGGGGGGGGTTTTOOOOOOOOOOOOOOOO
OOOOOOOOOOOOOOOOGGGGggggTTTTGGGGGGGGGGGGGGGTttgGGGggtTGTTTTGGGGGGGGGGTTTGTTTTTTTTOOOOOOOOOOOOOOOO
OOOOOOOOOOOOOOOOGGGGggggGTTTGGGGGGGGGGGGGGGGGGGGGGGGTGGGTTGGGGGGGGGGGGGTGGGGTGOOOOOOOOOOOOOOOOOOO
OOOOOOOOOOOOOOOTTTTTGGGGGGTGGGGGGGGGGGGGGGGGGGGGGGGGGGGGGGGGGGGGGGGGGGTTTGGGGGOOOOOOOOOOOOOOOOOOO
OOOOOOOOOOOOOOOTTTTTTGGGGGGGGGGGGGGGGGGGGGGGGGGGGGGGGGGGGGGGGGGGGGGGGGGTTTTGGTTOOOOOOOOOOOOOOOOOO
OOOOOOOOOOOOOOOOGGTTTTGGGGGGGGGGGGGGGGGGGGGGGGGGGGGGGGGGGGGGGGGGGGGGGGTTTTTTTTTTOOOOOOOOOOOOOOOOO
OOOOOOOOOOOOOOOTTTTTTTGGGGGGGGGGGGGGGGGGGGGGGGGGGGGGGGGGGGGGGGGGGGGGGGGGTTTTTTTTOOOOOOOOOOOOOOOOG
OOOOOOOOOOOOOOOTTTTTTGGGGGGGGGGGGGGGGGGGGGGGGGGGGGGGGGGGGGGGGGGGGGGGGGGTTTTTTTTTTOOOOOOOOOOOOOOOG
OOOOOOOOOOOOOOOTTTTTTTGGGGGGGGGGGGGGGGGGGGGGGGGGGGGGGGGGGGGGGGGGGGGGGGGGTTTTTTTTTOOOOOOOOOOOOOOOG
OOOOOOOOOOOOOTTTTTTTTGGGGGGGGGGGGGGGGGGGGGGGGGGGGGGGGGGGGGGGGGGGGGGGGGGGGTTTTTTTTOOOOOOOOOOOOOOOG
OOOOOOOOOOOOOOTTTTTTGGGGGGGGGGGGGGGGGGGGGGGGGGGGGGGGGGGGGGGGGGGGGGGGGGGGGTTTTGTTTOOOOOOOOOOOOOOOO
OOOOOOOOOOOOOOTTTTTTTGGGGGGGGGGGGGGGGGGGGGGGGGGGGGGGGGGGGGGGGGGGGGGGGGGGGGTTTTTTTOOOOOOOOOOOOOOOG
OOOOOOOOOOOOOOTTTTTGGGGGGGGGGGGGGGGGGGTGGGGGGGGGGGGGGGGGGGGGGGGGGGGGGGGGGGTTTTTTTOOOOOOOOOOOOOOOG
OOOOOOOOOOOOOOTTTTTGGGGGGGGGGGGGGgggtTTTTGGGGGGGGGGGGGGTTTGGGGGGGGGGGGGGGGGGTTTTTOOOOOOOOOOOOOOOG
OOOOOOOOOOOOOTTTTTGGGGGGGGGGGGGGGggggGGTGGGGGGGGGGGGTTTTTTTGTTTTGGGGGGGGGGGGTTTTTOOOOOOOOOOOOOOOG
OOOOOOOOOOOOOOTTTTTGGGGGGGGGGGGGGggggGGGGTGGGGGGGGGGGTTTTGGGTTTTTTGGGGGGGGGGTTTTTOOOOOOOOOOOOOOOG
OOOOOOOOOOOOOOOTTTTGGGGGGGTTTTGGGgggGGTTTGGGGTTGGGGGGTTTTGTGGTTTTTTTGGGGGGGGGTTTTOOOOOOOOOOOOOOOG
OOOOOOOOOOOOOOOTTTTGGGGGTTTTTTTGGgggGGGTTGGGGTTTGGGGGGTTTGGTGTTTTTTTTGGTGGGGTTTTTOOOOOOOOOOOOOOOG
OOOOOOOOOOOOOOOTTTTTTTGTTTTTTTTTTgggGGGTTGGGGGTTTTGGTTGGTTGTGTTTTTTTTTTTTGTTTTTTTOOOOOOOOOOOOOOOG
OOOOOOOOOOOOOOOTTTTTTTTTTTTTTTTTTGGTGGGTTGGGTGGGGGGGGGGGGGGTGGTTTTTTTTTTTTTTTTOOTOOOOOOOOOOOOOOOG
OOOOOOOOOOOOOOOTTTTOTTTTTTTTTTTTOTOTTOTTTOTTTOTTOOOOOOOTTTOTTOTTTTTTTTTTTTTTTTTTOOOOOOOOOOOOOOOOG
OOOOOOOOOOOOOOOOTTTTTTTTTTTTTTTTOTOOTTTTTTTOTTTOTTOTTTTTOTOTTOOOTTTTTTTTTTTTTTTTOOOOOOOOOOOOOOOOG
OOOOOOOOOOOOOOOOTTTTTTTTTOTTTTTTOOOTTOOTTOTTTTOTTTTTTOTTOOOTOTOOOTTTTTTTTTTTTTTTOOOOOOOOOOOOOOOOG
OOOOOOOOOOOOOOOOOTTTOOOOTTTOOOOOOOOOOOOOOOOOOTTOOOOOOOTOOOOOTOOOOOTTOTTTTTTTTTTTOOOOOOOOOOOOOOOOO
OOOOOOOOOOOOOOOOOOOOOOOOOOOOOOOOOOOOOOOOOOOOOOOOOOOOOOOOOOOOOOOOOOOOOOOOOOOOOOOOOOOOOOOOOOOOOOOOO
OOOOOOOOOOOOOOOOOOOOOOOOOOOOOOOOOOOOOOOOOOOOOOOOOOOOOOOOOOOOOOOOOOOOOOOOOOOOOOOOOOOOOOOOOOOOOOOOG
OOOOOOOOOOOOOOOOOOOOOOOOOOOOOOOOOOOOOOOOOOOOOOOOOOOOOOOOOOOOOOOOOOOOOOOOOOOOOOOOOOOOOOOOOOOOOOOOG
OOOOOOOOOOOOOOOOOOOOOOOOOOOOOOOOOOOOOOOOOOOOOOOOOOOOOOOOOOOOOOOOOOOOOOOOOOOOOOOOOOOOOOOOOOOOOOOOG
OOOOOOOOOOOOOOOOOOOOOOOOOOOOOOOOOOOOOOOOOOOOOOOOOOOOOOOOOOOOOOOOOOOOOOOOOOOOOOOOOOOOOOOOOOOOOOOOG
OOOOOOOOOOOOOOOOOOOOOOOOOOOOOOOOOOOOOOOOOOOOOOOOOOOOOOOOOOOOOOOOOOOOOOOOOOOOOOOOOOOOOOOOOOOOOOOOG
OOOOOOOOOOOOOOOOOOOOOOOOOOOOOOOOOOOOOOOOOOOOOOOOOOOOOOOOOOOOOOOOOOOOOOOOOOOOOOOOOOOOOOOOOOOOOOOOG
OOOOOOOOOOOOOOOOOOOOOOOOOOOOOOOOOOOOOOOOOOOOOOOOOOOOOOOOOOOOOOOOOOOOOOOOOOOOOOOOOOOOOOOOOOOOOOOOG
OOOOOOOOOOOOOOOOOOOOOOOOOOOOOOOOOOOOOOOOOOOOOOOOOOOOOOOOOOOOOOOOOOOOOOOOOOOOOOOOOOOOOOOOOOOOOOOOG
OOOOOOOOOOOOOOOOOOOOOOOOOOOOOOOOOOOOOOOOOOOOOOOOOOOOOOOOOOOOOOOOOOOOOOOOOOOOOOOOOOOOOOOOOOOOOOOOG
OOOOOOOOOOOOOOOOOOOOOOOOOOOOOOOOOOOOOOOOOOOOOOOOOOOOOOOOOOOOOOOOOOOOOOOOOOOOOOOOOOOOOOOOOOOOOOOOG
OOOOOOOOOOOOOOOOOOOOOOOOOOOOOOOOOOOOOOOOOOOOOOOOOOOOOOOOOOOOOOOOOOOOOOOOOOOOOOOOOOOOOOOOOOOOOOOOG
OOOOOOOOOOOOOOOOOOOOOOOOOOOOOOOOOOOOOOOOOOOOOOOOOOOOOOOOOOOOOOOOOOOOOOOOOOOOOOOOOOOOOOOOOOOOOOOOG
