type octile-corner
height 129
width 97
map
6666666666666666666666666666666666666666666666666666666666666666666666666666666666666666666666666
6666666666666666666666666666666666666666666666666666666666666666666666666666666666666666666666666
6666666666666666666666666666666666666666666666666666666666666666666666666666666666666666666666666
6666666666666666666666666666666666666666666666666666666666666666666666666666666666666666666666666
6666666666666666666666666666666666666666666666666666666666666666666666666666666666666666666666666
6666666666666666666666666666666666666666666666666666666666666666666666666666666666666666666666666
6666666666666666666666666666666666666666666666666666666666666666666666666666666666666666666666666
6666666666666666666666666666666666666666666666666666666666666666666666666666666666666666666666666
6666666666666666666666666666666666666666666666666666666666666666666666666666666666666666666666666
6666666666666666666666666666666666666666666666666666666666666666666666666666666666666666666666666
6666666666666666666666666666666666666666666666666666666666666666666666666666666666666666666666666
6666666666666666666666666666666666666666666666666666666666666666666666666666666666666666666666666
6666666666666666666666666666666666666666666666666666666666666666666666666666666666666666666666666
6666666666666666666666666666666666666666666666666666666666666666666666666666666666666666666666666
6666666666666666666666666666666666666666666666666666666666666666666666666666666666666666666666666
6666666666666666666666666666666666666666666666666666666666666666666666666666666666666666666666666
6666666666666666666666666666666666666666666666666666666666666666666666666666666666666666666666666
6666666666666666666666666666666666666666666666666666666666666666666666666666666666666666666666666
6666666666666666666666666666666666666666666666666666666666666666666666666666666666666666666666666
6666666666666666666666666666666666666666666666666666666666666666666666666666666666666666666666666
6666666666666666666666666666666666666666666666666666666666666666666666666666666666666666666666666
6666666666666666666666666666666666666666666666666666666666666666666666666666666666666666666666666
6666666666666666666666666666666666666666666666666666666666666666666666666666666666666666666666666
6666666666666666666666666666666666666666666666666666666666666666666666666666666666666666666666666
6666666666666666666666666666666666666666666666666666666666666666666666666666666666666666666666666
6666666666666666666666666666666666666666666666666666666666666666666666666666666666666666666666666
6666666666666666666666666666666666666666666666666666666666666666666666666666666666666666666666666
6666666666666666666666666666666666666666666666666666666666666666666666666666666666666666666666666
6666666666666666666666666666666666666666666666666666666666666666666666666666666666666666666666666
6666666666666666666666666666666666666666666666666666666666666666666666666666666666666666666666666
6666666666666666666666666666666666666666666666666666666666666666666666666666666666666666666666666
6666666666666666666666666666666666666666666666666666666666666666666666666666666666666666666666666
6666666666666666666666666666666666666666666666666666666666666666666666666666666666666666666666666
6666666666666666666666666666666666666666666666666666666666666666666666666666666666666666666666666
6666666666666666666666666666666666666666666666666666666666666666666666666666666666666666666666666
6666666666666666666666666666666666666666666666666666666666666666666666666666666666666666666666666
6666666666666666666666666666666666666666666666666666666666666666666666666666666666666666666666666
6666666666666666666666666666666666666666666666666667776666666666666666666666666666666666666666666
6666666666666666666666666666666666666666666666666777777766677666666666666666666666666666666666666
6666666666666666666666666666666666666666666667777777777777777776777666666666666666666666666666666
6666666666666666666666666666666666666666666667777777777777777777777766666666666666666666666666666
6666666666666666666666666666666666666666666667777777777777777777777766666666666666666666666666666
6666666666666666666666666666666666666666666667777777777777777777777666666666666666666666666666666
6666666666666666666666666666666666666666666667777777777777777777777666666666666666666666666666666
6666666666666666666666666666666666666666666667777777777777777777777766666666666666666666666666666
6666666666666666666666666666666666666666666677777777777777777777777766666666666666666666666666666
6666666666666666666666666666666666666666666677777777777777777777777666666666666666666666666666666
6666666666666666666666666666666666666666666667777777777777777777776666666666666666666666666666666
6666666666666666666666666666666666666666666667788777777777777777776666666666666666666666666666666
6666666666666666666666666666666666666666666688888887777777777777766666666666666666666666666666666
6666666666666666666666666666666666666666666888888888877777777777666666666666666666666666666666666
6666666666666666666666666666666666666666666888888888888887777777666666666666666666666666666666666
6666666666666666666666666666666666666666668888888888888887777777666666666666666666666666666666666
6666666666666666666666666666666666666666668888888888888887777777666666666666666666666666666666666
6666666666666666666666666666666666666666688888888888888887777777766666666666666666666666666666666
6666666666666666666666666666666666666666688888888888888887777777766666666666666666666666666666666
6666666666666666666666666666666666666666668888888888888888777777766666666666666666666666666666666
6666666666666666666666666666666666666666668888888888888888777777766666666666666666666666666666666
6666666666666666666666666666666666666666666886688888888888777777666666666666666666666666666666666
6666666666666666666666666666666666666666666666666688888887777777666666666666666666666666666666666
6666666666666666666666666666666666666666666666666666888887777776666666666666666666666666666666666
6666666666666666666666666666666666666666666666666666668866776666666666666666666666666666666666666
6666666666666666666666666666666666666666666666666666666666666666666666666666666666666666666666666
6666666666666666666666666666666666666666666666666666666666666666666666666666666666666666666666666
6666666666666666666666666666666666666666666666666666666666666666666666666666666666666666666666666
6666666666666666666666666666666666666666666666666666666666666666666666666666666666666666666666666
6666666666666666666666666666666666666666666666666666666666666666666666666666666666666666666666666
6666666666666666666666666666666666666666888666666666666666666666666666666666666666666666666666666
6666666666666666666666666666666666666688888886666666666666666666666666666666666666666666666666666
6666666666666666666666666666666666666888888888886668866666666666666666666666666666666666666666666
6666666666666666666666666666666666666888888888888888886666666666666666666666666666666666666666666
6666666666666666666666666666666667778888888888888888886666666666666666666666666666666666666666666
6666666666666666666666666666666677778888888888888888888666666666666666666666666666666666666666666
6666666666666666666666666666666777778888888888888888888866666666666666666666666666666666666666666
6666666666666666666666666666666777777888888888888888888866666666666666666666666666666666666666666
6666666666666666666666666666666777777788888888888888888866666666666666666666666666666666666666666
6666666666666666666666666666666777777788888888888888888666666666666666666666666666666666666666666
6666666666666666666666666666666677777788888888888888888666666666666666666666666666666666666666666
6666666666666666666666666666666667777788888888888886686666666666666666666666666666666666666666666
6666666666666666666666666666666677777777777778887776666666666666666666666666666666666666666666666
6666666666666666666666666666666677777777777777777777666666666666666666666666666666666666666666666
6666666666666666666666666666666677777777777777777777666666666666666666666666666666666666666666666
6666666666666666666666666666666777777777777777777766666666666666666666666666666666666666666666666
6666666666666666666666666666666777777777777777777766666666666666666666666666666666666666666666666
6666666666666666666666666666667777777777777777777766666666666666666666666666666666666666666666666
6666666666666666666666666666667777777777777777777766666666666666666666666666666666666666666666666
6666666666666666666666666666667777777777777777777766666666666666666666666666666666666666666666666
6666666666666666666666666666666777777777777777666666666666666666666666666666666666666666666666666
6666666666666666666666666666666777777777777777666666666666666666666666666666666666666666666666666
6666666666666666666666666666666777777777777777666666666666666666666666666666666666666666666666666
6666666666666666666666666666666677777777667776666666666666666666666666666666666666666666666666666
6666666666666666666666666666666666677766666666666666666666666666666666666666666666666666666666666
6666666666666666666666666666666666666666666666666666666666666666666666666666666666666666666666666
6666666666666666666666666666666666666666666666666666666666666666666666666666666666666666666666666
6666666666666666666666666666666666666666666666666666666666666666666666666666666666666666666666666
6666666666666666666666666666666666666666666666666666666666666666666666666666666666666666666666666
6666666666666666666666666666666666666666666666666666666666666666666666666666666666666666666666666
6666666666666666666666666666666666666666666666666666666666666666666666666666666666666666666666666
6666666666666666666666666666666666666666666666666666666666666666666666666666666666666666666666666
6666666666666666666666666666666666666666666666666666666666666666666666666666666666666666666666666
6666666666666666666666666666666666666666666666666666666666666666666666666666666666666666666666666
6666666666666666666666666666666666666666666666666666666666666666666666666666666666666666666666666
6666666666666666666666666666666666666666666666666666666666666666666666666666666666666666666666666
6666666666666666666666666666666666666666666666666666666666666666666666666666666666666666666666666
6666666666666666666666666666666666666666666666666666666666666666666666666666666666666666666666666
6666666666666666666666666666666666666666666666666666666666666666666666666666666666666666666666666
6666666666666666666666666666666666666666666666666666666666666666666666666666666666666666666666666
6666666666666666666666666666666666666666666666666666666666666666666666666666666666666666666666666
6666666666666666666666666666666666666666666666666666666666666666666666666666666666666666666666666
6666666666666666666666666666666666666666666666666666666666666666666666666666666666666666666666666
6666666666666666666666666666666666666666666666666666666666666666666666666666666666666666666666666
6666666666666666666666666666666666666666666666666666666666666666666666666666666666666666666666666
6666666666666666666666666666666666666666666666666666666666666666666666666666666666666666666666666
6666666666666666666666666666666666666666666666666666666666666666666666666666666666666666666666666
6666666666666666666666666666666666666666666666666666666666666666666666666666666666666666666666666
6666666666666666666666666666666666666666666666666666666666666666666666666666666666666666666666666
6666666666666666666666666666666666666666666666666666666666666666666666666666666666666666666666666
6666666666666666666666666666666666666666666666666666666666666666666666666666666666666666666666666
6666666666666666666666666666666666666666666666666666666666666666666666666666666666666666666666666
6666666666666666666666666666666666666666666666666666666666666666666666666666666666666666666666666
6666666666666666666666666666666666666666666666666666666666666666666666666666666666666666666666666
6666666666666666666666666666666666666666666666666666666666666666666666666666666666666666666666666
6666666666666666666666666666666666666666666666666666666666666666666666666666666666666666666666666
6666666666666666666666666666666666666666666666666666666666666666666666666666666666666666666666666
6666666666666666666666666666666666666666666666666666666666666666666666666666666666666666666666666
6666666666666666666666666666666666666666666666666666666666666666666666666666666666666666666666666
6666666666666666666666666666666666666666666666666666666666666666666666666666666666666666666666666
6666666666666666666666666666666666666666666666666666666666666666666666666666666666666666666666666
6666666666666666666666666666666666666666666666666666666666666666666666666666666666666666666666666
SSSSSSSSSSSSSSSSSSSSSSSSSSSSSSSSSSSSSSSSSSSSSSSSSSSSSSSSSSSSSSSSSSSSSSSSSSSSSSSSSSSSSSSSSSSSSSSSS
OOOOOOOOOOOOOOOOOOOOOOOOOOOOOOOOOOOOOOOOOOOOOOOOOOOOOOOOOOOOOOOOOOOOOOOOOOOOOOOOOOOOOOOOOOOOOOOOS
OOOOOOOOOOOOOOOOOOOOOOOOOOOOOOOOOOOOOOOOOOOOOOOOOOOOOOOOOOOOOOOOOOOOOOOOOOOOOOOOOOOOOOOOOOOOOOOOS
OOOOOOOOOOOOOOOOOOOOOOOOOOOOOOOOOOOOOOOOOOOOOOOOOOOOOOOOOOOOOOOOOOOOOOOOOOOOOOOOOOOOOOOOOOOOOOOOS
OOOOOOOOOOOOOOOOOOOOOOOOOOOOOOOOOOOOOOOOOOOOOOOOOOOOOOOOOOOOOOOOOOOOOOOOOOOOOOOOOOOOOOOOOOOOOOOOS
OOOOOOOOOOOOOOOOOOOOOOOOOOOOOOOOOOOOOOOOOOOOOOOOOOOOOOOOOOOOOOOOOOOOOOOOOOOOOOOOOOOOOOOOOOOOOOOOS
OOOOOOOOOOOOOOOOOOOOOOOOOOOOOOOOOOOOOOOOOOOOOOOOOOOOOOOOOOOOOOOOOOOOOOOOOOOOOOOOOOOOOOOOOOOOOOOOS
OOOOOOOOOOOOOOOOOOOOOOOOOOOOOOOOOOOOOOOOOOOOOOOOOOOOOOOOOOOOOOOOOOOOOOOOOOOOOOOOOOOOOOOOOOOOOOOOS
OOOOOOOOOOOOOOOOOOOOOOOOOOOOOOOOOOOOOOOOOOOOOOOOOOOOOOOOOOOOOOOOOOOOOOOOOOOOOOOOOOOOOOOOOOOOOOOOS
OOOOOOSSSSSSSSSSSSSSSSSSSSSSSSSSSSSSSSSSSSSSSSSSSSSSSSSSSSSSSSSSSSSSSSSSSSSSSSSSSSSSSSSSSSOOOOOOS
OOOOOOSSSSSSSSSSSSSSSSSSSSSSSSSSSSSSSSSSSSSSSSSSSSSSSSSSSSSSSSSSSSSSSSSSSSSSSSSSSSSTTSSSSSOOOOOOS
OOOOOOSSSSSSSTSTSSSSSSGGGGSSSSSSSTTTSSSSSSSSSSTSSSSSSSSSSSSSSSSSSSSSSSTTSSTSSSSSSSSTSSSSSSOOOOOOS
OOOOOOSSSSSSSTTGGGGGGTTTTGGGGGGSTTTTTSSSSSSSSSSTSSSSSSSSSSSSSSSSSTSTTTTTTTTSSSSSSSSTSSSSSSOOOOOOS
OOOOOOSSSSSSGGGGGGGGGTTTTTTGGGGGGTTTTTTSSSSSSTSSSSSSSSSSSSSSSSSSTTTTTTTTTTGSSSSSSSSSSSSSSSOOOOOOS
OOOOOOSSSSSGGGGGGGGGGTTTTTGGGGGGGTTTTTSSSSSSSSSSSSTSSSSSSSSSSSTGTTTTTTTTTTTGGSSSSSSSSSSSSSOOOOOOS
OOOOOOSSSSSGGGGGGGGGGGGTTGGGGGGGGGGTTGSSSSSSSSSSTTTTTSSSSSSSSTTTTTTTTTTTTTGGGGSSSSSSSSSSSSOOOOOOS
OOOOOOSSTTGGGGGGGGGGGGGGGGGGGGGGGGGGGSSSSSSSSSSTTTTTSSSSSSSSSTTTTTTTTTTTTTTGGGGGSSTTTSSSSSOOOOOOS
OOOOOOSSTTTGGGGGGGGGGGGGGGGGGGGGGGGGGSSSSSSSSSSSTTGGGGGSSSSSTTTTTTTTTTTTTTGGGGGGGTTTTTSSSSOOOOOOS
OOOOOOSSTGGGGGGGGGGGGGGGGGGGGGGGGGGGSSSSSSSSSSSTTGGGGGGSSSTSSTTTTTTTTTTTTGGGGGGGGTTTTTTSSSOOOOOOS
OOOOOOSSSGGGGGGGGGGGGGGGGGGGGGGGGGGSSSSSSSSSSTTTTTGGGGGGGSSSGTTTTTTTTTTTTGGGGGGGGGGGTTTTSSOOOOOOS
OOOOOOSSSGGGGGGGGGGGGGGGGGGGGGGGGGSSSSSSSSSSTTTTTTTGGGGGGGGGGGTTGGGTTTTTTTGGGGGGGGGGTTTTSSOOOOOOS
OOOOOOSSTTGGGGGGGGGGGGGGGGGGGGGGGSSSSSSSSSSSSTTTTTTTGGGGGGGGGGGGGGGTTTTTTGGGGGGGGGGGGTTTTSOOOOOOS
OOOOOOSSTTTGGGGGGGGGGGGGGGGGGGGGSSSSSSSSSSSSGGTTTTTTTGGGGGGGGGGGGGGGGGTTTGGGGGGGGGGGGTTTSSOOOOOOS
OOOOOOSTTTGGGGGGGGGGGGGGGGGGGTTGSSSSSSSSSSGGGGGTTTTTTTTGGGGGGGGGGGGGGGGGGGGGGGGGGGGGGTTTTSOOOOOOS
OOOOOOSSTGGGGGGGGGGGGGGGGGGTTTTSSSSSSSSSSGGGGGGGGTTTTTTTGGGGGGGGGGGGGGGGGGGGGGGGGGGGGTTGSSOOOOOOS
OOOOOOSSSGGGGGGGGGGGGGGGGGGTTTTTSSSSSSSSGGGGGGGGGTTTTTTTGGGGGGGGGGGGGGGGGGGGGGGGGGGGGGGGSSOOOOOOS
OOOOOOSSSGGTTGGGGGGGGGGGGGGTTTTSSSSSSSSSGGGGGGGGGTTGTTGGGGGGGGGGGGGGGGGGGGGGGGGGGGGGGGGGSSOOOOOOS
OOOOOOSSSGGTTTGGGGGGGGGGGGGGTTTSSSSSSTTGGGGGGGGGGGGGGGGGGGGGGGGGGGGGGGGGGGGGGGGGGGGGGGGSSSOOOOOOS
OOOOOOSSSSTTTTGGGGGGGGGGGGGGTTSSSSSSSTTTGGGGGGGGGGGGGGGGGGGGGGGGGGGGGGGGGGGGGGGGGGGGGGGSSSOOOOOOS
OOOOOOSSSSGTTTTGGGGGGGGGGGGGTTTSSSSSSTTTTGGGGGGGGGGGGGGGGGGGGGGGGGGGGGGGGGGGGGGGGGGGGGGSSSOOOOOOS
OOOOOOSSSSSTTGGGGGGGGGGTGGGTTTSSSSSSSTTTTTGGGGGGGGGGGGGGGGGGGGGGGGGGGGGGGGGGGGGGGGGTTGGSSSOOOOOOS
OOOOOOSSSSSSSGGGGGGGGGTTTTTTTSSSSSSSTTTTTGGGGGGGGGGGGGGGGGGGGGGGGGGGGGGGGGGGGGGGGGGTTTTTSSOOOOOOS
OOOOOOSSSSSSSSGGGGGGGGTTTTTTSSSSSSSSSTTTTGGGGGGGGGGGGGGGGGGGGGGGTTGGGGGGGGGGGGGGGTTTTTTTSSOOOOOOS
OOOOOOSSSSSSSSGGGGGGGGTTTTTSSSSSSSSSSGTTTGGGGGGGGGGGGGGGGGGGGGGGTTTTTGGGGGGGGGGGGTTTTTTTSSOOOOOOS
OOOOOOSSSSSSSSGGGGGGGGGTTTSSSSSSSSSSSGGTTGGGGGGGGGGGGTTTGGGGGGTTTTTTTGGGGGGGGGGGGTTTTTTTSSOOOOOOS
OOOOOOSSSSSSSSSGGGGGGGGGSSSSSSSSSSSSGGGGGGGGGGGGGGGGTTTTTGGGGGGTTTTTTTTTTGGGGGGGGGTTTTTTTSOOOOOOS
OOOOOOSSSSSSSSSSGGGGGGGGSSSSSSSSSSSSSGGGGGGGGGGGGGGGTTTTGGGGGGTTTTTTTTTTTGGGGGGGGTTTTTTTSSOOOOOOS
OOOOOOSSSSSSSSGGGGGGGGGGSSSSSSSSSSSSSGGGGGGgggggGGGGGGGTTTGGGTTTTTTTTTTTTGGGGGGGGGTTTTTTTSOOOOOOS
OOOOOOSSSSSSSSGGGGGGGGGGSSSSSSSSSSSSGGGGGGGgggggGGGTTGGGTTGGGTTTTTTTTTTTTGGGGGGGGGGGTTTTTSOOOOOOS
OOOOOOSSSSSSSGGGGGGGGGGGGSSSSSSSSSSSGGGGGGGgggggGGGTTTTGGGGTGGGGGGGGTTTTTGGGGGGGGGGGGTTTTSOOOOOOS
OOOOOOSSSSSSSGGGGGGGGGGGGGSSSSSSSSSGGGGGGGGgggGGGGGTGTGGTTTTTGGGGTGGTTTTTTGGGGGGGGGGTTTSSSOOOOOOS
OOOOOOSSSSSGGGGGGGGGGGGGGGGSSSSSSGGGGGGGGGGgggGGGGGGGGGTTTTTGGGGGTGGGTTTTTTGGGGGGGGGGTTTTSOOOOOOS
OOOOOOSSSSSGGGGGGGGGGGGGGGGGSSSGGGGGGGGGGGGgggGGGGGGGGGGTTGGGGGGGGGGTTTTTTTGGGGGGGGGTTTTSSOOOOOOS
OOOOOOSSSSSGGGGGGGGGGGGGGGGGGGGGGGGGGGGGGGGgggGGGGGGGGGGGGGGGGGGGGGGTTTTTTTTGGGGGGGGTTTTSSOOOOOOS
OOOOOOSSSSSGGGGGGGGGGGGGGGGGGGGGGGGGGGGGGGGGGGGGGGGGGGGGGGGGGGGGGGGGTTTTTTTGGGGGGGGGTTSSSSOOOOOOS
OOOOOOSSSSSGGGGGGGGGGGGGGGGGGGGGGGGGGGGGGGGGGGGGGGGGGGGGGGGGGGGGGTTGGGGTTTTGGGGGGGGGSSSSSSOOOOOOS
OOOOOOSSSSGGGGGGGGGGGGGGGGGGGGGGGGGGGGGGGGGGGGTTGGGGGGGGGGGGGGGGTTGGGGGGTTTGGGGGGGGGSSSSSSOOOOOOS
OOOOOOSSSSGGGGGGGGGGGGGGGGGGGGGGGGGGGGGGGGGGGTTTGGGGGGGGGGGGGGGGTGGGGGGGGTTGGGGGGGGGSSSSSSOOOOOOS
OOOOOOSSSSGGGGGGGGGGGGGGGGGGGGGGGGGGGGGGGGTTGTGGGGGGTGGGGGGGGGGGTGGGGGGGGGGGGGGGGGGSSSSSSSOOOOOOS
OOOOOOSSSSGGGGGGGGGGGGGGGGGGGGGGGGGGGGGTTTTGGGGTGGGTTGgggggGGGGGGGTGGGGGGGGGGGGGGGGSSSSSSSOOOOOOS
OOOOOOSSSSGGGGGGGGGGGGGGGGGGGGGGGGGGTTTTTTGGTTGGTTGGGGgggggGGGGGGTTTGGGGGGGGGGGGGGSSSSSSSSOOOOOOS
OOOOOOSSSGGGTTGTTGGGGGGGGGGGGGGGGGGGTTTTTTGTTGGGGGGGGGgggggGGGGGGTTTTGGGGGGGGGGGGSSSSSSSSSOOOOOOS
OOOOOOSSSGGTTTTTTTGGGGTTGGGGGGGGGGGTTTTTTGGGGGGGGGGGGGGGgggGGGGGTTTTTGGGGGGSGGSSSSSSSSSSSSOOOOOOS
OOOOOOSSSGTTTTTTTGGGGGTTGGGGGGGGGGGGTTTTTGGGGGGGGGGGGGGGgggGGGGGGTTTTGGGGGGSGSSSSSSSSSSSSSOOOOOOS
OOOOOOSSSGGTTTTTTTGGGGTTTTGTTGGGGGGGGGTTGGTGGGGGGGGGGGGGgggGGGGGGTTTTGGGGGGSSSSSSSSSSSSSSSOOOOOOS
OOOOOOSSSGGGTTTTTTTTTTTTTTTTTGGGGGGGGGGGGGTTGGGGGGGGGGGGGGGGGGGGGGTTGGGGGGGSSSSSSSSSSSSSSSOOOOOOS
OOOOOOSSSGGTTTTTTTTTTTTTTTTTTTGGGGGGGGGGGGTTGGGGGGGGGGGTGGGGGGGGGGGGGGGGGGSSSSSSSSSSSSSSSSOOOOOOS
OOOOOOSSSGTTTTTTTTTTTTTTTTTTTGGGGGGGGGGGGGGTTTTGGGGGGGGTTGGGGGGGGGGGGGGGGGSSSSSSSSSSSSSSSSOOOOOOS
OOOOOOSSSSGTTTGGTTTGGTTTTTTTGGGGGGGGGGGGGGGTGGGTGGGGGGTTTGGGGGGGGGGGGGGGGGSSSSSSSSSSSSSSSSOOOOOOS
OOOOOOSSSSGTGGGGTGGGGGTTTTTTGGGGGGGGGGGGGGGGGTGGGGGGGGGTGGGGGGGGGGGGGGGGGGGSSSSSSSSSSSSSSSOOOOOOS
OOOOOOSSSSGTTGGGGGGGGGGGTTTTGGGGGGGGGGGGGGGGGGGGGGGGGGGGGGGGGGGGGGGGGGGGGGGSSTTSSSSSSSSSSSOOOOOOS
OOOOOOSSSSTTTGGGGGGGGGGTTTTTGGGGGGGGGGGGGGGGGGGGGGGGGGGGGGGGGGGGGGGGGGGGGGGGTTTSSSSSSSSSSSOOOOOOS
OOOOOOSSSSGTTGGGGGGGGGGTTTTTTGGGGGGGGGGGGGGGGGGGGGGGGGGGGGGGGGGGGGGGGGGGGGGGGTTGGSSSSSSSSSOOOOOOS
OOOOOOSSSSSGTGGGGGGGGGGTTTTTGGGGGGGGGGGGGGGGGGGGGGGGGGGGGGGGGGGGGGGGGGGGGGGGGGGGGGGSSSSSSSOOOOOOS
OOOOOOSSSSSGGGGGGGGGGGGGTTTGGGGGGGGGGGGGGGGGGGGGGGGGGGGGGGGGGGGGGGGGGGGGGGGGGGGGGGGGGSSSSSOOOOOOS
OOOOOOSSSSSGGGGGGGGGGGGGTTGGGGGGGGGGGGGGGGGGGGGGGGGGGGGGGGGGGGGGGGGGGGGGGGGGGGGGGGGGGGSSSSOOOOOOS
OOOOOOSSSSSSGGGGGGGGGGGGGGGGGGGGGGGGGGGGGGGGGGGGGGGGGGGGGGGGGGGGGGGGGGGGGGGGGGGGGGGGGGSSSSOOOOOOS
OOOOOOSSSSSSSTTGGGGGGGGGGGGGGGGGGGGGGGGGGGGGGGGGGGGGGGGGGGGGGGGGGGGGGGGTTGGGGGGGGGGGGGGSSSOOOOOOS
OOOOOOSSSSSSSSTTTGGGGGGGGGGGGGGGGGGGGGGGGGGGGGGGGGGGGGGGGGGGGGGGGGGGGGTTTGGGGGGGGGGGTTGSSSOOOOOOS
OOOOOOSSSSSSSSSSSGGGTTGGGGGGGGGGGGGGGGTTGGGGGGGGGTGGGGGGGGGGGGGGGGGGGGGTTTTGGGGGGGGGTTTSSSOOOOOOS
OOOOOOSSSSSSSSSSSGGTTTSGGGGGGGGGGGGGGGTTGGGGGGGGGGGTGGGGGGGGGGGGGGGGTTTTTTGGGGGGGGGGTTGGSSOOOOOOS
OOOOOOSSSSSSSSSSSGGGTTSSGGGGGGGGGGGGGTTGGGGGGGGGGGTTTGGGGGGGGGGGGGGGTTTTTTTGGGGGGGGGGTTGSSOOOOOOS
OOOOOOSSSSSSSSSSSSSSSSSSGGGGGGGGGGGGGTTTGGGGGGGGGGGTTGGGGGGGGGGGGGGGTTTTTTTTGGGGGGGTTTTGSSOOOOOOS
OOOOOOSSSSSSSSSSSSSSSSSGGGGGGGGGGGGGTTTGGGGGGGGGGGGGTTGGGGGGGGGGGGGGTTTTTTTTTTTTGGTTTTTTSSOOOOOOS
OOOOOOSSSSSSSSSSSSSSSSSGGGGGGGGGGGGGGTGGGGGGGGGGGGGGGTTGGGGGGGGGGGGTTTTTTTTTTTTTTTTTTTTGSSOOOOOOS
OOOOOOSSSSSSSSSSSSSSSSGGGGGGGGGGGGGGGGGGGGGGGGGGGGGGGGTGTTGGGGGGGGGTTTTTTTTTTTTTTTTTTTTGSSOOOOOOS
OOOOOOSSSSSSSSSSSSSSSGGGGGGGGGGGGGGGgggGGGGGGGGGGGGGGGGGGTTGGGGGGGTTTTTTTTTTTGGTTTTTTTGGSSOOOOOOS
OOOOOOSSSSSSSSSSSSSSGGGGGGGGGTGGGGGGgggGGGGGGGGGGGGGGGGTTTGGGGGGGGGTTTTGGTTTGGGGGTTTTTTGSSOOOOOOS
OOOOOOSSSSSSSSSSSSSSGGGGGGGGTTTGGGGGggggggGGGGGGGGGGGGGGTTTGGGGGGGGGTTGGGTTTGGGGTTTTTTGGSSOOOOOOS
OOOOOOSSSSSSSSSSSSSGGGGGGGGGTTTGGGGGggggggGGGGGGGGGGGGTTTTTGGGGGGGGGGGGGGGTTGGGGGTTTTGGGSSOOOOOOS
OOOOOOSSSSSSSSSSSSSGGGGGGGTTTTTGGGGGggggggTTGGGGTTGGGTTTGTTGGGGGGGGGGGGGGGGGGGGGGGTTGGGGSSOOOOOOS
OOOOOOSSSTTSSSSSSSGGGGGGGTTTTTTGGTTGGGGGGGGTGTTGTTTGGTTGGGGGGGGGGGGGGGGGGGGGGGGGGGGGGGGGSSOOOOOOS
OOOOOOSSTTTSSSSSSSGGGGGGGGTTTTGGTTTGGGGGGGGGGGGGTGGGGGGGGGGGGGGGGGGGGGGGGGGGGGGGGGGGGGGGSSOOOOOOS
OOOOOOSSSTSGSSSSSSGGGGGGGGGTTTGGTTTGGGGGGGGGGGGGGgggGGGGGGGGGGGGGGGGGGGGGGGGGGGGGGGGGGGGSSOOOOOOS
OOOOOOSSSSSSSSSSSSSGGGGGGGGGGGGTTGGGGGGGGGGGGGGGGgggGGGGGGGGGGGGGGGGGGSSSSGGGGGGGGGGGGGGSSOOOOOOS
OOOOOOSSSSSSSSSSSSSGGGGGGGGGGGGTTGGGGGGGGGGGGGGGGgggGGGGGGGGGGGGGGGGGSSSSSSSSSGGGGGGGGGGSSOOOOOOS
OOOOOOSSSTTSSSSSSSSGGGGGGGGGGGGGGGGGGGGGGGGGGgggggggGGGGGGGGGGGGGGGGGSSSSSSSSSGGGGGGGGGGSSOOOOOOS
OOOOOOSSSSTSSSSSSSSGGGGGGGGTTGGGGGGGGGGGGGGGGgggggggGGGGGGGGGGGGGGGGSSSSSSSSSSGGGGGGGGGSSSOOOOOOS
OOOOOOSSSSSSSSSSSSSSGGGGGGTTTTGGGGGGGGTTGGTTGgggggggGGGGGGGGGGGGGGGSSSSSSSSSSSGGGGGGGGSSSSOOOOOOS
OOOOOOSSSSSSSSSSSSSSGGGGGTTTTTGGGGGGTTTTGTTTGGGGGGGGGGGGGGGGGGGGGGSSSSSSSSSSSSGGGGGGGGSSSSOOOOOOS
OOOOOOSSSSSSSSSSSSSSGGGGGTTTTTGGGGGTTTTGGGGTGGGGGGGGGGGGGGGGGGGGGTSSSSSSSSSSSSGGGGGGGGSSSSOOOOOOS
OOOOOOSSSSSSSSSSSSSSGGGGGTTTTTTGGGGTTGGGGGGGGTTGGGGGGGGGGGGGGGGGGSSSSSSSSSSSSSGGGGGGGSSSSSOOOOOOS
OOOOOOSSSSSSSSSSSSSGGGGGGGGTTTTTTTGGGGGGGGGTTTTTGGGGGGGGGGTTGTTGTSSSSSSSSSSSSSGGGGGGGSSSSSOOOOOOS
OOOOOOSSSSSSSSSSSSGGGGGGGGGTTTTTTTTTTTGGGGTTTTTGGGGGGGGGGTTTTTTTTSSSSSSSSSSSSGGGGGGGSSSSSSOOOOOOS
OOOOOOSSSSSSSSSSSTTGGGGGGGGGTTTTTTTTTTTGGGGTTTTGGGGGGGGGTTTTTTTSSSSSSSSSSSSSSGGGGGGGSSSSSSOOOOOOS
OOOOOOSSSSSSSSTTTTTTGGGGGGGTTTTTTTTTTTGGGGGGTTGGGGGGGGGGGTTTTTTSSSSSSSSSSSSSSGGGGGGGSSSSSSOOOOOOS
OOOOOOSSSSSSTTTTTTTTTGGGGGGTTTTTTTTTTTTGGGGGGGGGGGGGGGGGGTTTTSSSSSSSSSSSSSSGGGGGGGGGSSSSSSOOOOOOS
OOOOOOSSSSSSTTTTTTTTTGGGGGGTTTGTTTTTTGGGGGGGGGGGGGGGGSSSSTTTSSSSSSSSSSSGGGGGGGGGGGGGSSSSSSOOOOOOS
OOOOOOSSSSSTTTTTTTTTTGGGGGGGGGGGTTTTTTGGGGGGGGGGGGGGGSSSSTTSSSSSSSSTTTTGGGGGGGGGGGGSSSSSSSOOOOOOS
OOOOOOSSSSSTTTTTTTTTTGGGGGGGGGGGGTTTGGGGGGGGGGGGGGGGSSSSSSSSSSSSSSSTTTTTGGGGGGGGGGGGSSSSSSOOOOOOS
OOOOOOSSSSTTTTTTTTTTTGGGGGGGGGGGGGTTGGGGGGGGGGGGGGGGSSSSSSSSSSSSSTTTTTTGGGGGGGGGGGGGSSSSSSOOOOOOS
OOOOOOSSSSSTTTTTTTTTTTGGGGGGGGGGGGGGGGGGGGGGGGGGGGGGSSSSSSSSSSSSSTTTTTTTGGGGGGGGGGGGSSSSSSOOOOOOS
OOOOOOSSSSSTTTTTGGTTGGGGGGGGGGGGGGGGGGGGGGGGGGGGGGGGSSSSSSSSSSSTTTTTTTTTGGGGGGGGGGGGSSSSSSOOOOOOS
OOOOOOSSSSTTTTTTGGGGGGGGGGGGGGGGGGGGGGGGGGTTTGGGGGGGSSSSSSSSSSTTTTGGTTTGGGGGGGGGGGGGGSSSSSOOOOOOS
OOOOOOSSSSTTTTTGGGGGGGGGGGGGGGGGGGGGGGGGGGTTTTTGGGGGSSSSSSSSSTTTGGGGTTGGGGGGGGGGGGGGTTSSSSOOOOOOS
OOOOOOSSSSTTTGGGGGGGGGGGGGGGGGGGGGGGGGGGGGTTTTGGGGGGSSSSSSSSSGTTTGGGGGGGGGGGGGGGGGGTTTSSSSOOOOOOS
OOOOOOSSSSSSGGGGGGGGGGGGGGGGGGGGGGGGGGGGGGGGTTGGGGGGSSSSSSSSTTTTTGGGGGGGGGGGGGGGGGGGTTTTSSOOOOOOS
OOOOOOSSSSSGGGGGGGGGGGGGGGGGGGGGGGGGGGGGGGGGGGGGGGGGSSSSSSSSSTTTTGGGGGGGGGGGGGGGGGGGGTTTSSOOOOOOS
OOOOOOSSSSGGGGGGGGGGGGGGGGGGGGGGGGGGGGGGGGGGGGGGGGGGSSSSSSSSSTTTGGGGGGGGGGGGGGGGGGGGGTTTSSOOOOOOS
OOOOOOSSSSGGGGGGGGGGGGGGGGGGGGGGGGGGGGGGGGGGGGGGGGGSSSSSSSSSGGGGGGGGGGGGGGGGGGGGGGGGGTTGSSOOOOOOS
OOOOOOSSSSGGGGGGGGGGGGGGGGGGGGGGGGGGGGGGGGGGGGGGGGGSSSSSSSSSGGGGGGGGGGGGGGGGGGGGGGGGGGGGSSOOOOOOS
OOOOOOSSGGGGGGGGGGGGGGGGGGGGGGGGGGGGGGGGGTTGGGGGGGSSSSSSSSSSGGGGGGGGGGGGGGGGGGGGGGGGGGGGSSOOOOOOS
OOOOOOSSGTTGGGGGGGGGGGGGGGGGGGGGGGGGGGTTTTTTGGGGGGSSSSSSSSSSGGGGGGGGGGGGGGGGGGGGGGGGGGGGSSOOOOOOS
OOOOOOSSTTTTTGGGGGGGGGGGGGGGTTGGGGGGGGTTTTTTGGGGGGSSSSSSSSSSGGGGGGGGGGGGGGGGGGGGGGGGGGGGSSOOOOOOS
OOOOOOSSSTTTTGGGGGGGGGGGGGTTTTTTGGGGGGTTTTTTTGGGGGSSSSSSSSSSGGGGGGGGGGGGGGGGGGGGGGGGGGGGSSOOOOOOS
OOOOOOSSSTTTTTGGGGGGGGTTTGTTTTTTTGGGGGGGGTTTTTTTGSSSSSSSSSSSGGGGGGGGGGGGGGGGGGGGGGGGGGGGSSOOOOOOS
OOOOOOSSSSTTTTTGGGGGGTTTTTTTTTTTTGGGGSGGGGGTTTTTTTSSSSSSSSSSGGGGGGGGGGGGGGGGGGGGGGGGGGGSSSOOOOOOS
OOOOOOSSSSSSTTSGGGGGTTTTTTTTTTTTTGGGGGGGGGGGGGTTTTTSSSSSSSSSSGGGGGGGGGGGGGGGGGGGGGGGGGGSSSOOOOOOS
OOOOOOSSSSSSSSSSSSSTTTTTTTTTTTTTGSSSGGSGGGGGGGTTTTSSSSSSSSSSSSGGGGGGGGGGGGGTTGGGGGGGGGSSSSOOOOOOS
OOOOOOSSSSSSSSSSSSSSTTTTTTTTTTTTTSSTSSSGGGGGGTTTTSSSSSSSSSSSSSSGGGGGGGGGGTTTTGGGGGGGGSSSSSOOOOOOS
OOOOOOSSSSSSSSSSSSSSSSTTSTTTSSTTSSSSSSSGGGGGTTTTSSSSSSSSSSSSSSSGGGGGTTTGGTTTTTSSGGGSSSSSSSOOOOOOS
OOOOOOSSSSSSSSSSSSSSSSSSSSTTSSSSSSSSSSSSGGGGGTTSSSSSSSSSSSSSSSSSGGSSTTTTSTTTTTSSSSSSSSSSSSOOOOOOS
OOOOOOSSSSSSSSSSSSSSSSSSSSSSSSSSSSSSSSSSSSSGSSSSSSTTSSSSSSSSSSSSSSSSSTTSSSSSTTSSSSSSSSSSSSOOOOOOS
OOOOOOSSSSSSSSSSSSSSSSSSSSSSSSSSSSSSSSSSSSSSSSSSSSSTSSSSSSSSSSSSSSSSSSSSSSSSSSSSSSSSSSSSSSOOOOOOS
OOOOOOSSSSSSSSSSSSSSSSSSSSSSSSSSSSSSSSSSSSSSSSSSSSSSSSSSSSSSSSSSSSSSSSSSSSSSSSSSSSSSSSSSSSOOOOOOS
OOOOOOOOOOOOOOOOOOOOOOOOOOOOOOOOOOOOOOOOOOOOOOOOOOOOOOOOOOOOOOOOOOOOOOOOOOOOOOOOOOOOOOOOOOOOOOOOS
OOOOOOOOOOOOOOOOOOOOOOOOOOOOOOOOOOOOOOOOOOOOOOOOOOOOOOOOOOOOOOOOOOOOOOOOOOOOOOOOOOOOOOOOOOOOOOOOS
OOOOOOOOOOOOOOOOOOOOOOOOOOOOOOOOOOOOOOOOOOOOOOOOOOOOOOOOOOOOOOOOOOOOOOOOOOOOOOOOOOOOOOOOOOOOOOOOS
OOOOOOOOOOOOOOOOOOOOOOOOOOOOOOOOOOOOOOOOOOOOOOOOOOOOOOOOOOOOOOOOOOOOOOOOOOOOOOOOOOOOOOOOOOOOOOOOS
