type octile
height 130
width 130
map
@@@@@@@@@@@@@@@@@@@@@@@@@@@@TT@@@@@@@@@@@@@@@@@@@@@@@@@@@@@@@@@@@@@@@@@@@@@@@@@@@@@@@@@@@@@@@@@@@@@@@@@@@@@@@@@@@@@@@@@@@@@@@@@@@@
@@@@@@@@@@@@@@@@@@@TTTTTTTTT..T@@@@@@@@@@@@@@@@@@@@@@@@@@@@@@@@@@@@@@@@@@@@@@@@@@@@@@@@@@@@@@@@@@@@@@@@@@@@@@@@@@@@@@@@@@@@@@@@@@@
@@@@@@@@@@@@@@@@@@T............T@@@@@@@@@@@@@@@@@@@@@@@@@@@@@@@@@@@@@@@@@@@@@@@@@@@@@@@@@@@@@@@@@@@@@@@@@@@@@@@@@@@@@@@@@@@@@@@@@@
@@@@@@@@@@@@@@@@@T..............T@@@@@@@@@@@@@@@@@@@@@@@@@@@@@@@@@@@@@@@@@@@@@@@@@@@@@@@@@@@@@@@@@@@@@@@@@@@@@@@@@@@@@@@@@@@@@@@@@
@@@@@@@@@@@@@@@@@T..............T@@@@@@@@@@@@@@@@@@@@@@@@@@@@@@@@@@@@@@@@@@@@@@@@@@@@@@@@@@@@@@@@@@@@@@@@@@@@@@@@@@@@@@@@@@@@@@@@@
@@@@@@@@@@@@@@@@@T..............T@@@@@@@@@@@@@@@@@@@@@@@@@@@@@@@@@@@@@@@@@@@@@@@@@@@@@@@@@@@@@@@@@@@@@@@@@@@@@@@@@@@@@@@@@@@@@@@@@
@@@@@@@@@@@@@@@@@T..............T@@@@@@@@@@@@@@@@@@@@@@@@@@@@@@@@@@@@@@@@@@@@@@@@@@@@@@@@@@@@@@@@@@@@@@@@@@@@@@@@@@@@@@@@@@@@@@@@@
@@@@@@@@@@@@@@@@@@T............T@@@@@@@@@@@@@@@@@@@@@@@@@@@@@@@@@@@@@@@@@@@@@@@@@@@@@@@@@@@@@@@@@@@@@@@@@@@@@@@@@@@@@@@@@@@@@@@@@@
@@@@@@@@@@@@@@@@@@T............T@@@@@@@@@@@@@@@@@@@@@@@@@@@@@@@@@@@@@@@@@@@@@@@@@@@@@@@@@@@@@@@@@@@@@@@@@@@@@@@@@@@@@@@@@@@@@@@@@@
@@@@@@@@@@@@@@@@@@T............T@@@@@@@@@@@@@@@@@@TTTTT@@@@@@@@@@@@TTTTTTTTTTTTTTTTTTTTTTTTTTTTTTTT@@@@@@@@@@@@T@@@@@@@@@@@@@@@@@@
@@@@@@@@@@@@@@@@@@T............T@@@@@@@@@@@@@@@@@T.....T@@@@@@@@@@T................................T@@@@@@@@@@T.T@@@@@@@@@@@@@@@@@
@@@@@@@@@@@@@@@@@@T............T@@@@@@@@@@@@@@@@@T.....T@@@@@@@@@@T................................T@@@@@@@@@@T.T@@@@@@@@@@@@@@@@@
@@@@@@@@@@@@@@@@@@T............T@@@@@@@@@@@@@@@@@T.....T@@@@@@@@@@T................................T@@@@@@@@@@T.T@@@@@@@@@@@@@@@@@
@@@@@@@@@@@@@@@@@@T............T@@@@@@@@@@@@@@@@@T.....TTTT@@@@@@@T................................TTTTTTTTTTTT.T@@@@@@@@@@@@@@@@@
@@@@@@@@@@@@@@@@@@T............T@@@@@@@@@@@@@@@@@T.........TTTTTTTT.............................................T@@@@@@@@@@@@@@@@@
@@@@@@@@@@@@@@@@@T..............T@@@@@@@@@@@@@@@@T..............................................................T@@@@@@@@@@@@@@@@@
@@@@@@@@@@@@@@@@@T..............T@@@@@@@@@@@@@@@@T..............................................................T@@@@@@@@@@@@@@@@@
@@@@@@@@@@@@@@@@@T..............T@@@@@@@@@@@@@@@@T..............................................................T@@@@@@@@@@@@@@@@@
@@@@@@@@@@@@@@@@@T..............T@@@@@@@@@@@@@@@@T..........................TTT.................................T@@@@@@@@@@@@@@@@@
@@@@@@@@@@@@@@@@@T..............T@@@@@@@@@@@@@@@@T.........................T@@@T................................T@@@@@@@@@@@@@@@@@
@@@@@@@@@@@@@@@@@T..............T@@@@@@@@@@@@@@@@T.......................TT@@@@@TTTT............................T@@@@@@@@@@@@@@@@@
@@@@@@@@@@@@@@@@@T..............T@@@@@@@@@@@@@@@@T......................T@@@@@@@@@@@TTTT........................T@@@@@@@@@@@@@@@@@
@@@@@@@@@@@@@@@@@T..............T@@@@@@@@@@@@@@@@T......................T@@@@@@@@@@@@@@T........................T@@@@@@@@@@@@@@@@@
@@@@@@@@@@@@@@@@@T.............T@@@@@@@@@@@@@@@@@@T............TTTT.....T@@@@@@@@@@@@@@T.......TTTT.............T@@@@@@@@@@@@@@@@@
@@@@@@@@@@@@@@@@@T.............T@@@@@@@@@@@@@@@@@@T............T@@@TTTTT@@@@@@@@@@@@@@@@TTTTTTT@@@T.............T@@@@@@@@@@@@@@@@@
@@@@@@@@@@@@@@@@@T.............T@@@@@@@TTTTTTTT@@@T............T@@@@@@@@@@@@@@@@@@@@@@@@@@@@@@@@@@T.............T@@@@@@@@@@@@@@@@@
@@@@@@@@@@@@@@@@@T.............TTTTTTTT........TTTT............T@@@@@@@@@@@@@@@@@@@@@@@@@@@@@@@@@@T.............T@@@@@@@@@@@@@@@@@
@@@@@@@@@@@@@@@@@T..............................................T@@@@@@@@@@@@@@@@@@@@@@@@@@@@@@@@T..............T@@@@@@@@@@@@@@@@@
@@@@@@@@@@@@@@@@@T..............................................T@@@@@@@@@@@@@@@@@@@@@@@@@@@@@@@@T..............T@@@@@@@@@@@@@@@@@
@@@@@@@@@@@@@@@@@T..............................................T@@@@@@@@@@@@@@@@@@@@@@@@@@@@@@@@T..............T@@@@@@@@@@@@@@@@@
@@@@@@@@@@@@@@@@@T..............................................T@@@@@@@@@@@@@@@@@@@@@@@@@@@@@@@@T..............T@@@@@@@@@@@@@@@@@
@@@@@@@@@@@@@@@@@T..............................................T@@@@@@@@@@@@@@@@@@@@@@@@@@@@@@@@T..............T@@@@@@@@@@@@@@@@@
@@@@@@@@@@@@@@@@@T..............................................T@@@@@@@@@@@@@@@@@@@@@@@@@@@@@@@@T..............T@@@@@@@@@@@@@@@@@
@@@@@@@@@@@@@@@@@T..............................................T@@@@@@@@@@@@@@@@@@@@@@@@@@@@@@@@T..............T@@@@@@@@@@@@@@@@@
@@@@@@@@@@@@@@@@@T..............................................T@@@@@@@@@@@@@@@@@@@@@@@@@@@@@@@@T..............T@@@@@@@@@@@@@@@@@
@@@@@@@@@@@@@@@@@T..............................................T@@@@@@@@@@@@@@@@@@@@@@@@@@@@@@@@T..............T@@@@@@@@@@@@@@@@@
@@@@@@@@@@@@@@@@@T..............................................T@@@@@@@@@@@@@@@@@@@@@@@@@@@@@@@@T..............T@@@@@@@@@@@@@@@@@
@@@@@@@@@@@@@@@@@T..............................................T@@@@@@@@@@@@@@@@@@@@@@@@@@@@@@@@T..............T@@@@@@@@@@@@@@@@@
@@@@@@@@@@@@@@@@@T..............................................T@@@@@@@@@@@@@@@@@@@@@@@@@@@@@@@@T..............T@@@@@@@@@@@@@@@@@
@@@@@@@@@@@@@@@@@@T....TTTT....TTTT............................T@@@@@@@@@@@@@@@@@@@@@@@@@@@@@@@@@@T.............T@@@@@@@@@@@@@@@@@
@@@@@@@@@@@@@@@@@@@TTTT@@@@TTTT@@@@TTTTTTTTTTTTTTT.............T@@@@@@@@@@@@@@@@@@@@@@@@@@@@@@@@@@T.............T@@@@@@@@@@@@@@@@@
@@@@@@@@@@@@@@@@@@@@@@@@@@@@@@@@@@@TTTTTTTTTTTTTTT.............T@@@TTTTTTTTTTTTTTTTTTTTTTTTTTTT@@@T.............T@@@@@@@@@@@@@@@@@
@@@@@@@@@@@@@@@@@@@@@@@@@@@@@@@TTTT............................TTTT............................TTTT.............T@@@@@@@@@@@@@@@@@
@@@@@@@@@@@@@@@@@@@@@@@@@@@@@@T.................................................................................T@@@@@@@@@@@@@@@@@
@@@@@@@@@@@@@@@@@@@@@@@@@@TTTT..................................................................................T@@@@@@@@@@@@@@@@@
@@@@@@@@@@@@@@@@@@@@@@@@@T......................................................................................T@@@@@@@@@@@@@@@@@
@@@@@@@@@@@@@@@@@@@@@@@@@T......................................................................................T@@@@@@@@@@@@@@@@@
@@@@@@@@@@@@@@@@@@@@@@@@T.......................................................................................T@@@@@@@@@@@@@@@@@
@@@@@@@@@@@@@@@@@@@@@@@T.............................................................................TT.........T@@@@@@@@@@@@@@@@@
@@@@@@@@@@@@@@@@@@@@@@@@T.......................................................TT.................TT@T.........T@@@@@@@@@@@@@@@@@
@@@@@@@@@@@@@@@@@@@@@@@@@T....................................................TT@@TTTT............T@@@@TT.......T@@@@@@@@@@@@@@@@@
@@@@@@@@@@@@@@@@@@@@@@@@T....................................................T@@@@@@@@TTTT...TTTTT@@@@@@@TTTTTT.T@@@@@@@@@@@@@@@@@
@@@@@@@@@@@@@@@@@@@@@@@T...................................................TT@@@@@@@@@@@@T...T@@@@@@@@@@@@@@@@T.T@@@@@@@@@@@@@@@@@
@@@@@@@@@@@@@@@@@@@@@@@T...................................................T@@@@@@TTT@T@@@T.T@@@@@@@@TTT@@@@@@T.T@@@@@@@@@@@@@@@@@
@@@@@@@@@@@@@@@@@@@@@@@T....................................................T@@@@T...T.TTTT.TTTTT@@TT...TTTTTTT.T@@@@@@@@@@@@@@@@@
@@@@@@@@@@@@@@@@@@T@@@T.......................TTTTTT...TTTT...TTTTTT........T@T@@@T..............TT.............T@@@@@@@@@@@@@@@@@
@@@@@@@@@@@@@@@@@T.TTT........................T@@@@@TTT@@@@TTT@@@@@T.........T.T@@@TTTTTTTTTTTTTT@@TTTTTTTTTTTTT@@@@@@@@@@@@@@@@@@
@@@@@@@@@@@@@@@@@T............................T@@@@@@@@@@@@@@@@@@@@T...........T@@@@@@@@@@@@@@@@@@@@@@@@@@@@@@@@@@@@@@@@@@@@@@@@@@
@@@@@@@@@@@@@@@@@T............................T@@@@@@@@@@@@@@@@@@@@@T..........T@@@@@@@@@@@@@@@@@@@@@@@@@@@@@@@@@@@@@@@@@@@@@@@@@@
@@@@@@@@@@@@@@@@@T............................TT@@@@@@@@@@@@@@@@@@@@@T..........T@@@@@@@@@@@@@@@@@@@@@@@@@@@@@@@@@@@@@@@@@@@@@@@@@
@@@@@@@@@@@@@@@@@@TTTTT.........................T@@@@@@@@@@@@@@@@@@@@T..........T@@@@@@@@@@@@@@@@@@@@@@@@@@@@@@@@@@@@@@@@@@@@@@@@@
@@@@@@@@@@@@@@@@@@@@@@T.........................T@@@@@@@@@@@@@@@@@@@@T..........T@@@@@@@@@@@@@@@@@@@@@@@@@@@@@@@@@@@@@@@@@@@@@@@@@
@@@@@@@@@@@@@@@@@@@@@@T.........................T@@@@@@@@@@@@@@@@@@@@T..........T@@@@@@@@@@@@@@@@@@@@@@@@@@@@@@@@@@@@@@@@@@@@@@@@@
@@@@@@@@@@@@@@@@@@@@@@T........................T@@@@@@@@@@@@@@@@@@@@@T..........T@@@@@@@@@@@@@@@@@@@@@@@@@@@@@@@@@@@@@@@@@@@@@@@@@
@@@@@@@@@@@@@@@@@@@@@@T........................T@@@@@@@@@@@@@@@@@@@@T...........T@@@@@@@@@@@@@@@@@@@@@@@@@@@@@@@@@@@@@@@@@@@@@@@@@
@@@@@@@@@@@@@@@@@@@@@@T........................T@@@@@@@@@@@@@@@@@@@@T...........T@@@@@@@@@@@@@@@@@@@@@@@@@@@@@@@@@@@@@@@@@@@@@@@@@
@@@@@@@@@@@@@@@@@@@@@@@T.......................T@@@@@@@@@@@@@@@@@@TT............T@@@@@@@@@@@@@@@@@@@@@@@@@@@@@@@@@@@@@@@@@@@@@@@@@
@@@@@@@@@@@@@@@@@@@TTTTT........................T@@@@@@@@@@@@@@@@T..............T@@@@@@@@@@@@@@@@@@@@@@@@@@@@@@@@@@@@@@@@@@@@@@@@@
@@@@@@@@@@@@@@@@@@T.............................T@@@@@@@@@@@@@@@@T..............T@@@@@@@@@@@@@@@@@@@@@@@@@@@@@@@@@@@@@@@@@@@@@@@@@
@@@@@@@@@@@@@@@@@T..............................T@@@@@@@@@@@@@@@@T..............T@@@@@@@@@@@@@@@@@@@@@@@@@@@@@@@@@@@@@@@@@@@@@@@@@
@@@@@@@@@@@@@@@@@T.TTTT.......................TT@@@@@@@@@@@@@@@@@@TT............T@@@@@@@@@@@@@@@@@@@@@@@@@@@@@@@@@@@@@@@@@@@@@@@@@
@@@@@@@@@@@@@@@@@@T@@@T.......................T@@@@@@@@@@@@@@@@@@@@T...........T@@@@@@@@@@@@@@@@@@@@@@@@@@@@@@@@@@@@@@@@@@@@@@@@@@
@@@@@@@@@@@@@@@@@@@@@@T.......................T@@@@@@@@@@@@@@@@@@@@T...........T@@@@@@@@@@@@@@@@@@@@@@@@@@@@@@@@@@@@@@@@@@@@@@@@@@
@@@@@@@@@@@@@@@@@@@@@T........................T@@@@@TTT@@@@TTT@@@@@T...........T@@@TTTTTTTTTTTTTTTTTTTTTTTT@@@@@@TTTTTTTTTTTTTTT@@
@@@@@@@@@@@@@@@@@@@@T.........................TTTTTT...TTTT...TTTTTT...........TTTT........................TTTTTT...............T@
@@@@@@@@@@@@@@@@@@@@@T..........................................................................................................T@
@@@@@@@@@@@@@@@@@@@@@@T.........................................................................................................T@
@@@@@@@@@@@@@@@@@@@@@@@T........................................................................................................T@
@@@@@@@@@@@@@@@@@@@@@@@@T.......................................................................................................T@
@@@@@@@@@@@@@@@@@@@@@@@@@T......................................................................................................T@
@@@@@@@@@@@@@@@@@@@@@@@@@@T.....................................................................................................T@
@@@@@@@@@@@@@@@@@@@@@@@@@@@T....................................................................................................T@
@@@@@@@@@@@@@@@@@@@@@@@@@@@@T...................................................................................................T@
@@@@@@@@@@@@@@@@@@@@@@@@@@@@@T..................................................................................................T@
@@@@@@@@@@@@@@@@@@@@@@@@@@@@@@T.................................................................................................T@
@@@@@@@@@@@@@@@@@@@@@@@@@@@@@@@T................................................................................................T@
@@@@@@@@@@@@@@@@@@@@@@@@@@@@@@@@T...............................................................................................T@
@@@@@@@@@@@@@@@@@@@@@@@@@@@@@@@@@TT............................................................TTTT........TTTTTTTT.............T@
@@@@@@@@@@@@@@@@@@@@@@@@@@@@@@@@@@T.....TT.....................................................T@@@TTTTTTTT@@@@@@@T.............T@
@@@@@@@@@@@@@@@@@@@@@@@@@@@@@@@@@@T.....TT....................................................T@@@@@@@@@@@@@@@@@@@T.............T@
@@@@@@@@@@@@@@@@@@@@@@@@@@@@@@@@@@T.....TT...................................................T@@@@@@@@@@@@@@@@@@@@T.............T@
@@@@@@@@@@@@@@@@@@@@@@@@@@@@@@@@@T......TT..................................................T@@@@@@@@@@@@@@@@@@@@T..............T@
@@@@@@@@@@@@@@@@@@@@@@@@@@@@@@@@@T......TT.TTT.............................................T@@@@@@@@@@@@@@@@@@@@@T..............T@
@@@@@@@@@@@@@@@@@@@@@@@@@@@@@@@@@T......T@T@@@T...........................................T@@@@@@@@@@@@@@@@@@@@@@T..............T@
@@@@@@@@@@@@@@@@@@@@@@@@@@@@@@@@@T......T@@@@@T..........................................T@@@@@@@@@@@@@@@@@@@@@@@T..............T@
@@@@@@@@@@@@@@@@@@@@@@@@@@@@@@@@@T......T@@@@@T.........................................T@@@@@@@@@@@@@@@@@@@@@@@@T..............T@
@@@@@@@@@@@@@@@@@@@@@@@@@@@@@@@@@T......T@@@@@T........................................T@@@@@@@@@@@@@@@@@@@@@@@@@T..............T@
@@@@@@@@@@@@@@@@@@@@@@@@@@@@@@@@@T......T@@@@T....................TTTTTT.............TT@@@@@@@@@@@@@@@@@@@@@@@@@@T..............T@
@@@@@@@@@@@@@@@@@@@@@@@@@@@@@@@@@T......T@@@@T....................T@@@@T............T@@@@@@@@@@@@@@@@@@@@@@@@@@@@T..............T@
@@@@@@@@@@@@@@@@@@@@@@@@@@@@@@@@@@T.....T@@@@T.................T.T@@@@@@T.........TT@@@@@@@@@@@@@@@@@@@@@@@@@@@@@@T............T@@
@@@@@@@@@@@@@@@@@@@@@@@@@@@@@@@@@@T.....T@@@@@T.............TTT@T@@@@@@@T........T@@@@@@@@@@@@@@@@@@@@@@@@@@@@@@@@T............T@@
@@@@@@@@@@@@@@@@@@@@@@@@@@@@@@@@@@T.....T@@@@@@T............T@@@@@@@@@@@T........T@@@@@@@@@@@@@@@@@@@@@@@@@@@@@@@@T............T@@
@@@@@@@@@@@@@@@@@@@@@@@@@@@@@@@@@@T.....T@@TTTTT...........T@@@@@@@@@@@@T........T@@@@@@@@@@@@@@@@@@@@@@@@@@@@@@@@T............T@@
@@@@@@@@@@@@@@@@@@@@@@@@@@@@@@@@@@T....T@@T................T@@@@@@@@@@@@@TT....TT@@@@@@@@@@@@@@@@@@@@@@@@@@@@@@@@@T............T@@
@@@@@@@@@@@@@@@@@@@@@@@@@@@@@@@@@@T....T@@@TTTTTTTTTTTTTTTT@@@@@@@@@@@@@@@@T..T@@@@@@@@@@@@@@@@@@@@@@@@@@@@@@@@@@@T............T@@
@@@TTTTTTTTTTTTTTTTTTTTTTTTTTTT@@@T....T@@@TTTT@@@@TTTT@@@@TTTT@@@@TTTT@@@@@TT@@@@@@@@@@@@@@@@@@@@@@@@@@@@@@@@@@@@T............T@@
@@T............................TTTT....TTTT....TTTT....TTTT....TTTT....T@@@@@@@@@@@@@@@@@@@@@@@@@@@@@@@@@@@@@@@@@@T............T@@
@T......................................................................T@@@@@@@@@@@@@@@@@@@@@@@@@@@@@@@@@@@@@@@@T..............T@
T.......................................................................T@@@@@@@@@@@@@@@@@@@@@@@@@@@@@@@@@@@@@@@@T..............T@
T.......................................................................T@@@@@@@@@@@@@@@@@@@@@@@@@@@@@@@@@@@@@@@@T..............T@
@T......................................................................T@@@@@@@@@@@@@@@@@@@@@@@@@@@@@@@@@@@@@@@@T..............T@
@T......................................................................T@@@@@@@@@@@@@@@@@@@@@@@@@@@@@@@@@@@@@@@@@T............T@@
@T......................................................................T@@@@@@@@@@@@@@@@@@@@@@@@@@@@@@@@@@@@@@@@@@T..TTTTTTTTT@@@
@T......................................................................T@@@@@@@@@@@@@@@@@@@@@@@@@@@@@@@@@@@@@@@@@@@TT@@@@@@@@@@@@
@T......................................................................T@@@@@@@@@@@@@@@@@@@@@@@@@@@@@@@@@@@@@@@@@@@@@@@@@@@@@@@@@
@T......................................................................T@@@@@@@@@@@@@@@@@@@@@@@@@@@@@@@@@@@@@@@@@@@@@@@@@@@@@@@@@
@T......................................................................T@@@@@@@@@@@@@@@@@@@@@@@@@@@@@@@@@@@@@@@@@@@@@@@@@@@@@@@@@
@T......................................................................T@@@@@@@@@@@@@@@@@@@@@@@@@@@@@@@@@@@@@@@@@@@@@@@@@@@@@@@@@
@T......................................................................T@@@@@@@@@@@@@@@@@@@@@@@@@@@@@@@@@@@@@@@@@@@@@@@@@@@@@@@@@
@@T....................................................................T@@@@@@@@@@@@@@@@@@@@@@@@@@@@@@@@@@@@@@@@@@@@@@@@@@@@@@@@@@
@@@TTTTTTTTTTTTTTTTTTTTTTTTTTTTTTTTTTTTTTTTTTTTTTTTTTTTTTTTTTTTTTTTTTTT@@@@@@@@@@@@@@@@@@@@@@@@@@@@@@@@@@@@@@@@@@@@@@@@@@@@@@@@@@@
@@@@@@@@@@@@@@@@@@@@@@@@@@@@@@@@@@@@@@@@@@@@@@@@@@@@@@@@@@@@@@@@@@@@@@@@@@@@@@@@@@@@@@@@@@@@@@@@@@@@@@@@@@@@@@@@@@@@@@@@@@@@@@@@@@
@@@@@@@@@@@@@@@@@@@@@@@@@@@@@@@@@@@@@@@@@@@@@@@@@@@@@@@@@@@@@@@@@@@@@@@@@@@@@@@@@@@@@@@@@@@@@@@@@@@@@@@@@@@@@@@@@@@@@@@@@@@@@@@@@@
@@@@@@@@@@@@@@@@@@@@@@@@@@@@@@@@@@@@@@@@@@@@@@@@@@@@@@@@@@@@@@@@@@@@@@@@@@@@@@@@@@@@@@@@@@@@@@@@@@@@@@@@@@@@@@@@@@@@@@@@@@@@@@@@@@
@@@@@@@@@@@@@@@@@@@@@@@@@@@@@@@@@@@@@@@@@@@@@@@@@@@@@@@@@@@@@@@@@@@@@@@@@@@@@@@@@@@@@@@@@@@@@@@@@@@@@@@@@@@@@@@@@@@@@@@@@@@@@@@@@@
@@@@@@@@@@@@@@@@@@@@@@@@@@@@@@@@@@@@@@@@@@@@@@@@@@@@@@@@@@@@@@@@@@@@@@@@@@@@@@@@@@@@@@@@@@@@@@@@@@@@@@@@@@@@@@@@@@@@@@@@@@@@@@@@@@
@@@@@@@@@@@@@@@@@@@@@@@@@@@@@@@@@@@@@@@@@@@@@@@@@@@@@@@@@@@@@@@@@@@@@@@@@@@@@@@@@@@@@@@@@@@@@@@@@@@@@@@@@@@@@@@@@@@@@@@@@@@@@@@@@@
@@@@@@@@@@@@@@@@@@@@@@@@@@@@@@@@@@@@@@@@@@@@@@@@@@@@@@@@@@@@@@@@@@@@@@@@@@@@@@@@@@@@@@@@@@@@@@@@@@@@@@@@@@@@@@@@@@@@@@@@@@@@@@@@@@
@@@@@@@@@@@@@@@@@@@@@@@@@@@@@@@@@@@@@@@@@@@@@@@@@@@@@@@@@@@@@@@@@@@@@@@@@@@@@@@@@@@@@@@@@@@@@@@@@@@@@@@@@@@@@@@@@@@@@@@@@@@@@@@@@@
@@@@@@@@@@@@@@@@@@@@@@@@@@@@@@@@@@@@@@@@@@@@@@@@@@@@@@@@@@@@@@@@@@@@@@@@@@@@@@@@@@@@@@@@@@@@@@@@@@@@@@@@@@@@@@@@@@@@@@@@@@@@@@@@@@
