type octile
height 135
width 129
map
@@@@@@@@@@@@@@@@@@@@@@@@@@@@@@@@@@@@@@@@@@@@@@@@@@@@@@@@@@@@@@@@@@@@@@@@@@@@@@@@@@@@@@@@@@@@@@@@@@@@@@@@@@@@@@@@@@@@@@@@@@@@@@@@@
@@@@@@@@@@@@@@@@@@@@@@@@@@@@@@@@@@@@@@@@@@@@@@@@@@@@@@@@@@@@@@@@@@@@@@@@@@@@@@@@@@@@@@@@@@@@@@@@@@@@@@@@@@@@@@@@@@@@@@@@@@@@@@@@@
@@@@@@@@@@@@@@@@@@@@@@@@@@@@@@@@@@@@@@@@@@@@@@@@@@@@@@@@@@@@@@@@@@@@@@@@@@@@@@@@@@@@@@@@@@@@@@@@@@@@@@@@@@@@@@@@@@@@@@@@@@@@@@@@@
@@@@@@@@@@@@@@@@@@@@@@@@@@@@@@@@@@@@@@@@@@@@@@@@@@@@@@@@@@@@@@@@@@@@@@@@@@@@@@@@@@@@@@@@@@@@@@@@@@@@@@@@@@@@@@@@@@@@@@@@@@@@@@@@@
@@@@@@@@@@@@@@@@@@@@@@@@@@@@@@@@@@@@@@@@@@@@@@@@@@@@@@@@@@@@@@@@@@@@@@@@@@@@@@@@@@@@@@@@@@@@@@@@@@@@@@@@@@@@@@@@@@@@@@@@@@@@@@@@@
@@@@@@@@@@@@@@@@@@@@@@@@@@@@@@@@@@@@@@@@@@@@@@@@@@@@@@@@@@@@@@@@@@@@@@@@@@@@@@@@@@@@@@@@@@@@@@@@@@@@@@@@@@@@@@@@@@@@@@@@@@@@@@@@@
@@@@@@@@@@@@@@@@@@@@TTT@@@@@@TTTTT@@@@@@@@@@@@@@@@@@@@@@@@@@@@T@@@@@@@@@@@@@@@@@@@@@@@@@@@@@@@@@@@@@@@@@@@@@@@@@@@@@@@@@@@@@@@@@@
@@@@@@@@@@@@@@@@@@@T...T@@@@T.....T@@@@@@@@@@@@@@@@@@@@@@@@@@T.T@@@@@@@@@@@@@@@@@@@@@@@@@@@@@@@@@@@@@@@@@@@@@@@@@@@@@@@@@@@@@@@@@
@@@@@@@@@@@@@@@@@@T....TTTTTT.....T@@@@@@@@@@TTTTTTTTTTTTTTTT..TTT@@@@@@@@@@@@@@@@@@@@@@@@@@@@@@@@@@@@@@@@@@@@@@@@@@@@@@@@@@@@@@@
@@@@@@@@@@@@@@@@@@T.............TT@@@@@@T@@@T.....................T@@@@@@@@@@@@@@@@@@@@@@@@@@@@@@@@@@@@@@@@@@@@@@@@@@@@@@@@@@@@@@
@@@@@@@@@@@@@@@@@@T...TTT..TTT..TT@@@@@T.T@@T....................T@@@@@@@@@@@@@@@@@@@@@@@@@@@@@@@@@@@@@@@@@@@@@@@@@@@@@@@@@@@@@@@
@@@@@@@@@@@@@@@@TTT...T@T..T@T....TT@@@T.TTTT....................T@@@@@@@@@@@@@@@@@@@@@@@@@@@@@@@@@@@@@@@@@@@@@@@@@@@@@@@@@@@@@@@
@@@@@@@@@@@@@@@T.......TT...T.......T@@T.T........................T@@@@@@@@@@@@@@@@@@@@@@@@@@@@@@@@@@@@@@@@@@@@@@@@@@@@@@@@@@@@@@
@@@@@@@@@@@@@@@@TTT.................T@@T..........................T@@@@@@@@@@@@@@@@@@@@@@@@@@@@@@@@@@@@@@@@@@@@@@@@@@@@@@@@@@@@@@
@@@@@@@@@@@@@@@@@@@T................TTTT..........................T@@@@@@@@@@@@@@@@@@@@@@@@@@@@@@@@@@@@@@@@@@@@@@@@@@@@@@@@@@@@@@
@@@@@@@@@@@@@@@@@@@T..............................................T@@@@@@@@@@@@@@@@@@@@@@@@@@@@@@@@@@@@@@@@@@@@@@@@@@@@@@@@@@@@@@
@@@@@@@@@@@@@@@@@@T...............................................T@@@@@@@@@@@@@@@@@@@@@@@@@@@@@@@@@@@@@@@@@@@@@@@@@@@@@@@@@@@@@@
@@@@@@@@@@@@@@@@@@T...............................................T@@@@@@@@@@@@@@@@@@@@@@@@@@@@@@@@@@@@@@@@@@@@@@@@@@@@@@@@@@@@@@
@@@@@@@@@@@@@@@@TTT...............................................T@@@@@@@@@@@@@@@@@@@@@@@@@@@@@@@@@@@@@@@@@@@@@@@@@@@@@@@@@@@@@@
@@@@@@@@@@@@@@@T....................TTTTTTTTTTTT..................TT@@@@@@@@@@@@@@@@@@@@@@@@@@@@@@@@@@@@@@@@@@@@@@@@@@@@@@@@@@@@@
@@@@@@@@@@@@@@@T..................TT@@@@@@@@@@@T....................T@@@@@@@@@@@@@@@@@@@@@@@@@@@@@@@@@@@@@@@@@@@@@@@@@@@@@@@@@@@@
@@@@@@@@@@@@@@@@T.TT.............T@@@@@@@@@@@@@T...................T@@@@@@@@@@@@@@@@@@@@@@@@@@@@@@@@@@@@@@@@@@@@@@@@@@@@@@@@@@@@@
@@@@@@@@@@@@@@@@@T@T.............T@@@@@@@@@@@@@T...................T@@@@@@@@@@@@@@@@@@@@@@@@@@@@@@@@@@@@@@@@@@@@@@@@@@@@@@@@@@@@@
@@@@@@@@@@@@@@@@@@@@T............T@@@@@@@@@@@@@T...................T@@@@@@@@@@@@@@@@@@@@@@@@@@@@@@@@@@@@@@@@@@@@@@@@@@@@@@@@@@@@@
@@@@@@@@@@@@@@@@@@@@T...........T@@@@@@@@@@@@@@T..............TTTTT@@@@@@@@@@@@@@@@@@@@@@@@@@@@@@@@@@@@@@@@@@@@@@@@@@@@@@@@@@@@@@
@@@@@@@@@@@@@@@@@@@@@TT........T@@@@@@@@@@@@@@@@TTTTTTTTT....T@@@@@@@@@@@@@@@@@@@@@@@@@@@@@@@@@@@@@@@@@@@@@@@@@@@@@@@@@@@@@@@@@@@
@@@@@@@@@@@@@@@@@@@@@@T........T@@@@@@@@@@@@@@@@@@@@@@@@T....T@@@@@@@@@@@@@@@@@@@@@@@@@@@@@@@@@@@@@@@@@@@@@@@@@@@@@@@@@@@@@@@@@@@
@@@@@@@@@@@@@@@@@@@@@@@T....TTT@@@@@@@@@@@@@@@@@@@@@@@@@@TTTT@@@@@@@@@@@@@@@@@@@@@@@@@@@@@@@@@@@@@@@@@@@@@@@@@@@@@@@@@@@@@@@@@@@@
@@@@@@@@@@@@@@@@@@@@@@@T....T@@@@@@@@@@@@@@@@@@@@@@@@@@@@@@@@@@@@@@@@@@@@@@@@@@@@@@@@@@@@@@@@@@@@@@@@@@@@@@@@@@@@@@@@@@@@@@@@@@@@
@@@@@@@@@@@@@@@@@@@@@@@T....T@@@@@@@@@@@TTTT@@@@@@@@@@@@@@@@@@@@@@@@@@@@@@@@@@@@@@@@@@@@@@@@@@@@@@@@@@@@@@@@@@@@@@@@@@@@@@@@@@@@@
@@@@@@@@@@@@@@TTTTTTTTTT....T@@TTTTTT@@T....T@@@@@@@@@@@@@@@@@@@@@@@@@@@@@@@@@@@@@@@@@@@@@@@@@@@@@@@@@@@@@@@@@@@@@@@@@@@@@@@@@@@@
@@@@@@@@@@@@@T...............TT......TT......T@@@@@@@@@@@@@@@@@@@@@@@@@@@@@@@@@@@@@@@@@@@@@@@@@@@@@@@@@@@@@@@@@@@@@@@@@@@@@@@@@@@
@@@@@@@@@@@@@@T..............................TTTTT@@@@@@@@@TTTTTT@@@@@@@@@@@@@@@@@@@@@@@@@@@@@@@@@@@@@@@@@@@@@@@@@@@@@@@@@@@@@@@@
@@@@@@@@@@@@@@T...................................T@@@@@@@T......T@@@@@@@@@@@@@@@@@@@@@@@@@@@@@@@@@@@@@@@@@@@@@@@@@@@@@@@@@@@@@@@
@@@@@@@@@@@@@@@T..................................T@@@@@@@T......T@@@@@@@@@@@@@@@@@@@@@@@@@@@@@@@@@@@@@@@@@@@@@@@@@@@@@@@@@@@@@@@
@@@@@@@@@@@@@@@@T.................................T@@@@@TTT.......T@@@@@@@@@@@@@@@@@@@@@@@@@@@@@@@@@@@@@@@@@@@@@@@@@@@@@@@@@@@@@@
@@@@@@@@@@@@@@@TT.................................T@@@@T...........T@@@@@@@@@@@@@@@@@@@@@@@@@@@@@@@@@@@@@@@@@@@@@@@@@@@@@@@@@@@@@
@@@@@@@@@@@@@@T...................................T@@@@T...........T@@@@@@@@@@@@@@@@@@@@@@@@@@@@@@@@@@@@@@@@@@@@@@@@@@@@@@@@@@@@@
@@@@@@@@@@@@@TT....................................T@@@@T..........T@@@@@@@@@@@@@@@@@@@@@@@@@@@@@@@@@@@@@@@@@@@@@@@@@@@@@@@@@@@@@
@@@@@@@@@@@@T......................................T@@@@@T.........T@@@@@@@@@@@@@@@@@@@@@@@@@@@@@@@@@@@@@@@@@@@@@@@@@@@@@@@@@@@@@
@@@@@@@@@@@T........................................T@@@@T.........T@@@@@@@@@@@@@@@@@@@@@@@@@@@@@@@@@@@@@@@@@@@@@@@@@@@@@@@@@@@@@
@@@@@@@@@@@@T.................TTTT..................T@@@@T.........T@@@@@@@@@@@@@@@@@@@@@@@@@@@@@@@@@@@@@@@@@@@@@@@@@@@@@@@@@@@@@
@@@@@@@@@@@@T................T@@@T...TT.............T@@@@T........T@@@@@@@@@@@@@@@@@@@@@@@@@@@@@@@@@@@@@@@@@@@@@@@@@@@@@@@@@@@@@@
@@@@@@@@@@@@@TTTTTTTTTTT....T@@@@@TTT@@T............T@@@@T........T@@@@@@@@@@@@@@@@@@@@@@@@@@@@@@@@@@@@@@@@@@@@@@@@@@@@@@@@@@@@@@
@@@@@@@@@@@@@@@@@@@@@@@T....T@@@@@@@@@@T............T@@@TT........T@@@@@@@@@@@@@@@@@@@@@@@@@@@@@@@@@@@@@@@@@@@@@@@@@@@@@@@@@@@@@@
@@@@@@@@@@@@@@@@@@@@@@@T....T@@@@@@@@@@T............T@@T..........TT@@@@@@@@@@@@@@@@@@@@@@@@@@@@@@@@@@@@@@@@@@@@@@@@@@@@@@@@@@@@@
@@@@@@@@@@@@@@@@@@TTTTTT....TTT@@@@@@@@T............TTTT............T@@@@@@@@@@@@@@@@@@@@@@@@@@@@@@@@@@@@@@@@@@@@@@@@@@@@@@@@@@@@
@@@@@@@@@@@@@@@@@T.............T@@@@@@@T.............................TT@@@@@@@@@@@@@@@@@@@@@@@@@@@@@@@@@@@@@@@@@@@@@@@@@@@@@@@@@@
@@@@@@@@@@@@@@@@@T.............T@@@@@@@@T..............................TTTTT@@@@@@@@@@@@@@@@@@@@@@@@@@@@@@@@@@@@@@@@@@@@@@@@@@@@@
@@@@@@@@@@@@@@@@T..............T@@@@@@@@@T..................................T@@@@@@@@@@@@@@@@@@@@@@@@@@@@@@@@@@@@@@@@@@@@@@@@@@@@
@@@@@@@@@@@@@@@@T...............TT@@@@@@@T................................TT@@@@@@@@@@@@@@@@@@@@@@@@@@@@@@@@@@@@@@@@@@@@@@@@@@@@@
@@@@@@@@@@@@@@@@T.................T@@@@@@T..........TTTT..................T@@@@@@@@@@@@@@@@@@@@@@@@@@@@@@@@@@@@@@@@@@@@@@@@@@@@@@
@@@@@@@@@@@@@@@@@T................T@@@@@@T.........T@@@T..................T@@@@@@@@@@@@@@@@@@@@@@@@@@@@@@@@@@@@@@@@@@@@@@@@@@@@@@
@@@@@@@@@@@@@@@@TT................T@@@@@T..........T@@@@TT................T@@@@@@@@@@@@@@@@@@@@@@@@@@@@@@@@@@@@@@@@@@@@@@@@@@@@@@
@@@@@@@@@@@@@@@T..................T@@@@@@T.........T@@@@@@TT..............T@@@@@@@@@@@@@@@@@@@@@@@@@@@@@@@@@@@@@@@@@@@@@@@@@@@@@@
@@@@@@@@@@@@@@@T..................T@@@@@@T..........T@@@@@@@T.............TT@@@@@@@@@@@@@@@@@@@@@@@@@@@@@@@@@@@@@@@@@@@@@@@@@@@@@
@@@@@@@@@@@@@@@T..................T@@@@@@T..........T@@@@@@@T..........TT...T@@@@@@@@@@@@@@@@@@@@@@@@@@@@@@@@@@@@@@@@@@@@@@@@@@@@
@@@@@@@@@@@@@@@T.............TTTT.T@@@@@@T..........T@@@@@TTT..........T@TTT@@@@@@@@@@@@@@@@@@@@@@@@@@@@@@@@@@@@@@@@@@@@@@@@@@@@@
@@@@@@@@@@@@@@@T.............T@@@T@@@@@@@T..........T@@@@T............T@@@@@@@@@@@@@@@@@@@@@@@@@@@@@@@@@@@@@@@@@@@@@@@@@@@@@@@@@@
@@@@@@@@@@@@@@@@TTTTTTTTTTTTT@@@@@@@@@@@@T.........T@@@@@@TTTTTT....TT@@@@@@@@@@@@@@@@@@@@@@@@@@@@@@@@@@@@@@@@@@@@@@@@@@@@@@@@@@@
@@@@@@@@@@@@@@@@@@@@@@@@@@@@@@@@@@@@@@@@@T........T@@@@@@@@@@@@T....T@@@@@@@@@@@@@@@@@@@@@@@@@@@@@@@@@@@@@@@@@@@@@@@@@@@@@@@@@@@@
@@@@@@@@@@@@@@@@@@@@@@@@@@@@@@@@@@@@@@@@@T........T@@@@@@@@@@@@T....T@@@@@@@@@@@@@@@@@@@@@@@@@@@@@@@@@@@@@@@@@@@@@@@@@@@@@@@@@@@@
@@@@@@@@@@@TTT@@@@@@@@@@@@@@@@@@T@@@@@@@@T........T@@@@@@@TTTTTT....T@@@@@@@@@@@@@@@@@@@@@@@@@@@@@@@@@@@TTTTT@@@@@@@@@@@@@@@@@@@@
@@@@@@@@@TT...TTT@@@@@@@@@@@@@@T.T@@@@@@T..........T@@@@@T..........T@@@@@@@@@@@@@@@@@@@@@@@@@@@@@@@@@@T.....T@@@@@@@@@@@@@@@@@@@
@@@@@@@@T........TTTTTTTTTTTTTTT.T@@@@@@T..........T@@@@@@T......TTT@@@@@@@@@@@@@@@@@@@@@@@@@@@@@@@@@@@T.....TTTTT@@@@@@@@@@@@@@@
@@@@@@@T.........................T@@@@@T...........T@@@@@T.......T@@@@@@@@@@@@@@@@@@@@@@@@@@@@@@@@@@@@@T..........T@@@@@@@@@@@@@@
@@@@@@@@TT.......................T@@@@@T...........T@@@@@T.......T@@@@@@@@@@@@@@@@@@@@@@@@@@@@@@@@@@@@@T..........T@@@@@@@@@@@@@@
@@@@@@@@@T.......................TTT@@@T...........T@@@@@@TTTTTTT@@@@@@@@@@@@@@@@@@@@@@@@@@@@@@@@@@@@@@T..........T@@@@@@@@@@@@@@
@@@@@@@@@T..........................T@@T...........T@@@@@@@@@@@@@@@@@@@@@@@@@@@@@@@@@@@@@@@@@@@@@@@@@@@T..........T@@@@@@@@@@@@@@
@@@@@@@@@T..........................T@@T...........T@@@@@@@@@@@@@@@@@@@@@@@@@@@@@@@@@@@@@@@@@@@@@@@@@@@T..........T@@@@@@@@@@@@@@
@@@@@@@@@T..........................TTTT...........T@@@@@@@@@@@@@@@@@@@@@@@@@@@@@@@@@@@@@@@@@@@@@@@@@@@T..........T@@@@@@@@@@@@@@
@@@@@@@@TT.........................................T@@@@@@@@@@@@@@@@@@@@@@@@@@@@@@@@@@@@@@@@@@@@@@@@@@@T..........T@@@@@@@@@@@@@@
@@@@@@@T............................................T@@@@@@@@@@@@@@@@@@@@@@@@@@@@@@@@@@@@@@@@@@@@@@@@@@T..........T@@@@@@@@@@@@@@
@@@@@@@T.TTTT...TT..................................T@@@@@@@@@@@@@@@@@@@@@@@@@@@@@@@@@@@@@@@@@@@@@@@@@@T...........T@@@@@@@@@@@@@
@@@@@@@@T@@@T..T@T..................................T@@@@@@@@@@@@@@@@@@@@@@@@@@@@@@@@@@@@@@@@@@@@@@@@@@T............T@@@@@@@@@@@@
@@@@@@@@@@@@@TT@@@T.........TTTTTTTTTTTT............T@@@@@@@@@@@@@@@@@@@@@@@@@@@@@@@@@@@@@@@@@@@@@@@@@@@TTTTTTTT....T@@@@@@@@@@@@
@@@@@@@@@@@@@@@@@@T.........T@@@@@@@@@@T............T@@@@@@@@@@@@@@@@@@@@@@@@@@@@@@@@@@@@@@@@@@@@@@@@@@@@@@@@@@T....T@@@@@@@@@@@@
@@@@@@@@@@@@@@@@@@T.........T@@@@@@@@@@T............T@@@@@@@@@@@@@@@@@@@@@@@@@@@@@@@@@@@@@@@@@@@@@@@@@@@@@@@@@@T....T@@@@@@@@@@@@
@@@@@@@@@@@@@@@@@T..........T@@@@@@@@@@@T...........T@@@@@@@@@@@@@@@@@@@TTTTTTT@@@@@@TT@@@@@@@@@@@@@@@@@@@@@@@@T....T@@@@@@@@@@@@
@@@@@@@@@@@@@@@TT............TTT@@@@@@@@@T...........T@@@@@@@@@@@@@@@@@T.......T@@@@T..T@@@@@@TT@@@@@@@@@@@@@@T.....T@@@@@@@@@@@@
@@@@@@@@@@@@@@T.................T@@@@@@@@T...........T@@@@@@@@@@@@@@@@@T.......T@@@@T..T@@@@@T..TTTT@@@@TTTTTTT.....T@@@@@@@@@@@@
@@@@@@@@@@@@@@T.................T@@@@@@@@T...........T@@@@@@@@@@@@@@@@@T.......T@@@@T..T@@@@@T......TT@T...........T@@@@@@@@@@@@@
@@@@@@@@@@@@@@@TTTT.............T@@@@@@@@T...........T@@@@@@@@@@@@@@@@@T...TTT..TTTT....TTTTT.........T@T..........T@@@@@@@@@@@@@
@@@@@@@@@@@@@@@@@@@T............T@@@@@@@@T..........T@@@@@@@@@@@@@@@@@@T...T@@T.......................T@T..........T@@@@@@@@@@@@@
@@@@@@@@@@@@@@@@@@@T............TTTT@@@@T...........T@@@@@@@@@@@@@@@@@@T...T@@@T......................T@T..........T@@@@@@@@@@@@@
@@@@@@@@@@@@@@@@@@@T................T@@T............T@@@@@@@@@@@@@@@@@@T...T@@@@T....................T@T..........TT@@@@@@@@@@@@@
@@@@@@@@@@@@@@@@@@@T................T@@T............T@@@@@@@@@@@@@@@@@@T...T@@@@@T........TTTT.......T@T............T@@@@@@@@@@@@
@@@@@@@@@@@@@@@@@@@T.................T@T............T@@@@@@@@@@@@@@@@@@T...T@@@@@T.......T@@@T.......T@T............T@@@@@@@@@@@@
@@@@@@@@@@@@@@@@@@@@TTTT.............T@T............T@@@@@@@@@@@@@@@@@@T...T@@@TT........T@@@T.......T@T............T@@@@@@@@@@@@
@@@@@@@@@@@@@@@@@@@@@@@@TTTTTTTTTTTTT@T.............T@@@@@@@@@@@@@@@@@@T....TTT..........T@@@T.......T@T...TT.......T@@@@@@@@@@@@
@@@@@@@@@@@@@@@@@@@@@@@@@@@@@@@@@@@@@@T.............T@@@@@@@@@@@@@@@@@@T.................T@@@T.......T@T.TT@@T....TT@@@@@@@@@@@@@
@@@@@@@@@@@@@@@@@@@@@@@@@@@@@@@@@@@@@@@T............T@@@@@@@@@@@@@@@@@@T..................T@@T.......T@@T@TTT@TTT.T@@@@@@@@@@@@@@
@@@@@@@@@@@@@@@@@@@@@@@@@@@@@@@@@@@@@@@T............T@@@@@@@@@@@@@@@@@@T...........TTTTTTT@@@@T......TTTTT...TTTT.T@@@@@@@@@@@@@@
@@@@@@@@@@@@@@@@@@@@@@@@@@@@@@@@@@@@@@@T............T@@@@@@@@@@@@@@@@@@T...........T@@@@@@@@@@@T...................T@@@@@@@@@@@@@
@@@@@@@@@@@@@@@@@@@@@@T@@@@@@TTTTTTTTTTT............TTTTTTTTTTTTTTTTTTTT..........T@@@@@@@@@@@@T...................T@@@@@@@@@@@@@
@@@@@@@@@TTTTTTTTTT@@T.TTTTTT......................................................T@@@@T@@@@@@T...................T@@@@@@@@@@@@@
@@@@@@@@T..........TT...............................................................TTTT.T@@@@T....................T@@@@@@@@@@@@@
@@@@@@@@T................................................................................TT@@T....TTTTTT..........T@@@@@@@@@@@@@@
@@@@@@@@@T....TTTTTTTTT....................................................................TT....T@@@@@T..........T@@@@@@@@@@@@@@
@@@@@@@@@T....T@@@@@@@@TTT..........TTTT.....TTT....TTTTTTTTTTTTTTTTTTTT.........................T@@@@@@TT........T@@@@@@@@@@@@@@
@@@@@@@@@T.TT.T@@@@@@@@@@T..........T@@T..TTT@@T..TT@@@@@@@@@@@@@@@@@@@T..........................T@@@@@@T........T@@@@@@@@@@@@@@
@@@@@@@@@T.TT.T@@@@@@@@@@T..........T@@@TT@@@@@T.T@@@@@@@@@@@@@@@@@@@@@@T..........................T@@@@TT........T@@@@@@@@@@@@@@
@@@@@@@@@T.TT.T@@@@@@@@TTT..........T@@@@@@@@@@@T@@@@@@@@@@@@@@@@@@@@@@@@TTT.......................T@@TT.......TTT@@@@@@@@@@@@@@@
@@@@@@@@@@T...TTTTTTTTT...........TT@@@@@@@@@@@@@@@@@@@@@@@@@@@@@@@@@@@@@@@@T......................T@T........T@@@@@@@@@@@@@@@@@@
@@@@@@@@@@@T......................T@@@@@@@@@@@@@@@@@@@@@@@@@@@@@@@@@@@@@@@@T........................TT........T@@@@@@@@@@@@@@@@@@
@@@@@@@@@@@@T.TTTTTT..............T@@@@@@@@@@@@@@@@@@@@@@@@@@@@@@@@@@@@@@@@@T..TTTTTT.........................T@@@@@@@@@@@@@@@@@@
@@@@@@@@@@@@T.T@@@@@TTTTT.........T@@@@@@@@@@@@@@@@@@@@@@@@@@@@@@@@@@@@@@@@@@T.T@@@@T.........................T@@@TT@@@@@@@@@@@@@
@@@@@@@@@@@@@T@@@@@@@@@@T.........T@@@@@@@@@@@@@@@@@@@@@@@@@@@@@@@@@@@@@@@@@@@T@@@@@@TTT......................T@@T..T@@@@@@@@@@@@
@@@@@@@@@@@@@@@@@@@@@@@@T.........TT@@@@@@@@@@@@@@@@@@@@@@@@@@@@@@@@@@@@@@@@@@@@@@@@@@@T.......................TTT..T@@@@@@@@@@@@
@@@@@@@@@@@@@@@@@@@@@@@@T...........T@@@@@@@@@@@@@@@@@@@@@@@@@@@@@@@@@@@@@@@@@@@@@@@@@@T............................T@@@@@@@@@@@@
@@@@@@@@@@@@@@@@@@@@@@@@T...........TTTTTTTTTTTTT@@@@@@@@@@@@@@@@@@@@@@@@@@@@@@@@@@@@@@@TT.............T............TTTTTTTT@@@@@
@@@@@@@@@@@@@@@@@@@@@@@T.........................T@@@@@@@@@@@@@@@@@@@@@@@@@@@@@@@@@@@@@@@T............T@TT..................T@@@@
@@@@@@@@@@@@@@@@@@@@@@@@TTT.......................TT@@@@@@@@@@@@@@@@@@@@@@@@@@@@@@@@@@@@@T............T@@@T.................T@@@@
@@@@@@@@@@@@@@@@@@@@@@@@TTT.........................T@@@@@@@@@@@@@@@@@@@@@@@@@@@@@@@@@@@@T....TT.......T@@@T................T@@@@
@@@@@@@@@@@@@@@@@@@@@@@T.....................TTTTTTT@@@@@@@@@@@@@@@@@@@@@@@@@@@@@@@@@@@@TT..TT@@T......T@T@T................T@@@@
@@@@@@@@@@@@@@@@@@@@@@@@TT..........TTTT.....T@@@@@@@@@@@@@@@@@@@@@@@@@@@@@@@@@@@@@@@@@T....T@T@@T......T.T.........TTTT....T@@@@
@@@@@@@@@@@@@@@@@@@@@@@@@T..........T@@T.....T@@@@@@@@@@@@@@@@@@@@@@@@@@@@@@@@@@@@@@@@@T....TT.TT...................T@@@TTTT@@@@@
@@@@@@@@@@@@@@@@@@@@@@@@T...........T@@T.....T@@@@@@@@@@@@@@@@@@@@@@@@@@@@@@@@@@@@@@@@@T............................T@@@@@@@@@@@@
@@@@@@@@@@@@@@@@@@@@@@@T............TTTT.....T@@@@@@@@@@@@@@@@@@@@@@@@@@@@@@@@@@@@@@@@@T.TTT........................T@@@@@@@@@@@@
@@@@@@@@@@@@@@@@@@@@@@@T.....................TTTTTTT@@@@@@@@@@@@@@@@@@@@@@@@@@@@@@@@@@@T.T@@T.......................T@@@@@@@@@@@@
@@@@@@@@@@@@@@@@@@@@@@@@TTTTT.......................T@@@@@@@@@@@@@@@@@@@@@@@@@@@@@@@@@@T.T@@T...........TTTTT.......T@@@@@@@@@@@@
@@@@@@@@@@@@@@@@@@@@@@@@@@@@@TTTT...................T@@@@@@@@@@@@@@@@@@@@@@@@@@@@@@@@@@T.T@@T..TTTTTT..T@@@@@T......T@@@@@@@@@@@@
@@@@@@@@@@@@@@@@@@@@@@@@@@@@@@@@@TTTT.......TTTTT...T@@@@@@@@@@@@@@@@@@@@@@@@@@@@@@@@@@T.T@@@TT@@@@@T..T@@@@@T.TTT..T@@@@@@@@@@@@
@@@@@@@@@@@@@@@@@@@@@@@@@@@@@@@@@@@@@TTTTTTT@@@@@TTT@@@@@@@@@@@@@@@@@@@@@@@@@@@@@@@@@@@@T@@@@@@@@@@@@TT@@@@@@@T@@@TT@@@@@@@@@@@@@
@@@@@@@@@@@@@@@@@@@@@@@@@@@@@@@@@@@@@@@@@@@@@@@@@@@@@@@@@@@@@@@@@@@@@@@@@@@@@@@@@@@@@@@@@@@@@@@@@@@@@@@@@@@@@@@@@@@@@@@@@@@@@@@@@
@@@@@@@@@@@@@@@@@@@@@@@@@@@@@@@@@@@@@@@@@@@@@@@@@@@@@@@@@@@@@@@@@@@@@@@@@@@@@@@@@@@@@@@@@@@@@@@@@@@@@@@@@@@@@@@@@@@@@@@@@@@@@@@@@
@@@@@@@@@@@@@@@@@@@@@@@@@@@@@@@@@@@@@@@@@@@@@@@@@@@@@@@@@@@@@@@@@@@@@@@@@@@@@@@@@@@@@@@@@@@@@@@@@@@@@@@@@@@@@@@@@@@@@@@@@@@@@@@@@
@@@@@@@@@@@@@@@@@@@@@@@@@@@@@@@@@@@@@@@@@@@@@@@@@@@@@@@@@@@@@@@@@@@@@@@@@@@@@@@@@@@@@@@@@@@@@@@@@@@@@@@@@@@@@@@@@@@@@@@@@@@@@@@@@
@@@@@@@@@@@@@@@@@@@@@@@@@@@@@@@@@@@@@@@@@@@@@@@@@@@@@@@@@@@@@@@@@@@@@@@@@@@@@@@@@@@@@@@@@@@@@@@@@@@@@@@@@@@@@@@@@@@@@@@@@@@@@@@@@
@@@@@@@@@@@@@@@@@@@@@@@@@@@@@@@@@@@@@@@@@@@@@@@@@@@@@@@@@@@@@@@@@@@@@@@@@@@@@@@@@@@@@@@@@@@@@@@@@@@@@@@@@@@@@@@@@@@@@@@@@@@@@@@@@
@@@@@@@@@@@@@@@@@@@@@@@@@@@@@@@@@@@@@@@@@@@@@@@@@@@@@@@@@@@@@@@@@@@@@@@@@@@@@@@@@@@@@@@@@@@@@@@@@@@@@@@@@@@@@@@@@@@@@@@@@@@@@@@@@
@@@@@@@@@@@@@@@@@@@@@@@@@@@@@@@@@@@@@@@@@@@@@@@@@@@@@@@@@@@@@@@@@@@@@@@@@@@@@@@@@@@@@@@@@@@@@@@@@@@@@@@@@@@@@@@@@@@@@@@@@@@@@@@@@
@@@@@@@@@@@@@@@@@@@@@@@@@@@@@@@@@@@@@@@@@@@@@@@@@@@@@@@@@@@@@@@@@@@@@@@@@@@@@@@@@@@@@@@@@@@@@@@@@@@@@@@@@@@@@@@@@@@@@@@@@@@@@@@@@
@@@@@@@@@@@@@@@@@@@@@@@@@@@@@@@@@@@@@@@@@@@@@@@@@@@@@@@@@@@@@@@@@@@@@@@@@@@@@@@@@@@@@@@@@@@@@@@@@@@@@@@@@@@@@@@@@@@@@@@@@@@@@@@@@
@@@@@@@@@@@@@@@@@@@@@@@@@@@@@@@@@@@@@@@@@@@@@@@@@@@@@@@@@@@@@@@@@@@@@@@@@@@@@@@@@@@@@@@@@@@@@@@@@@@@@@@@@@@@@@@@@@@@@@@@@@@@@@@@@
