type octile
height 40
width 40
map
........@........@.................@..@@
........@........@.................@..@@
..@..@@@@@@@..@..@..@@@@@@@@@@..@@@@..@@
..@.....@..@..@..@..@.................@@
..@.....@..@..@..@..@.................@@
@@@..@@@@..@@@@..@..@..@@@@@@@@@@@@@..@@
..............@.....@...........@.....@@
..............@.....@...........@.....@@
@@@@@@..@@@@@@@..@@@@@@@@@@@@@..@..@@@@@
.....@.....@.....@.....@........@.....@@
.....@.....@.....@.....@........@.....@@
..@..@..@@@@..@@@@@@@..@@@@..@@@@..@@@@@
..@........@..............@.....@..@..@@
..@........@..............@.....@..@..@@
@@@@@@..@@@@..@..@@@@@@@..@@@@..@@@@..@@
.....@..@.....@..@.....@.....@........@@
.....@..@.....@..@.....@.....@........@@
@@@..@..@@@@@@@@@@..@@@@..@@@@@@@@@@..@@
.....@........@.................@.....@@
.....@........@.................@.....@@
..@@@@@@@@@@..@@@@@@@@@@@@@@@@..@..@@@@@
........@..@........@.....@.....@.....@@
........@..@........@.....@.....@.....@@
..@..@..@..@@@@@@@..@..@..@@@@@@@@@@..@@
..@..@.....@........@..@.....@..@.....@@
..@..@.....@........@..@.....@..@.....@@
..@..@@@@..@..@@@@@@@..@@@@..@..@..@@@@@
..@.....@..@...........@.....@........@@
..@.....@..@...........@.....@........@@
@@@..@@@@@@@@@@@@@@@@@@@..@..@@@@@@@..@@
...........@.....@.....@..@..@........@@
...........@.....@.....@..@..@........@@
@@@..@@@@..@@@@..@..@..@..@..@..@@@@@@@@
.....@........@.....@..@..@..@........@@
.....@........@.....@..@..@..@........@@
..@@@@..@@@@@@@..@@@@..@..@..@@@@@@@..@@
.....@..............@.....@...........@@
.....@..............@.....@...........@@
@@@@@@@@@@@@@@@@@@@@@@@@@@@@@@@@@@@@@@@@
@@@@@@@@@@@@@@@@@@@@@@@@@@@@@@@@@@@@@@@@
