type octile
height 80
width 80
map
........@@@.............@@........................@@..................@@@..@@@@@
........@@@.............@@........................@@..................@@@..@@@@@
........@@@.............@@........................@@..................@@@..@@@@@
@@@@@@..@@@..@@@@@@@@...@@@@@@@@@@@@@..@@@@@@@@...@@@@@@@@@@@@...@@@..@@@..@@@@@
@@@@@@..@@@..@@@@@@@@...@@@@@@@@@@@@@..@@@@@@@@...@@@@@@@@@@@@...@@@..@@@..@@@@@
@@@@@@..@@@..@@@@@@@@...@@@@@@@@@@@@@..@@@@@@@@...@@@@@@@@@@@@...@@@..@@@..@@@@@
...@@@..@@@........@@..................@@@..@@@...@@.............@@@.......@@@@@
...@@@..@@@........@@..................@@@..@@@...@@.............@@@.......@@@@@
...@@@..@@@@@@@@...@@@@@@@...@@@@@@@@@@@@@..@@@...@@...@@@@@@@@@@@@@@@@@@..@@@@@
...@@@..@@@@@@@@...@@@@@@@...@@@@@@@@@@@@@..@@@...@@...@@@@@@@@@@@@@@@@@@..@@@@@
...@@@..@@@@@@@@...@@@@@@@...@@@@@@@@@@@@@..@@@...@@...@@@@@@@@@@@@@@@@@@..@@@@@
...@@@..@@@..@@@........@@...@@........@@@..@@@...@@........@@.............@@@@@
...@@@..@@@..@@@........@@...@@........@@@..@@@...@@........@@.............@@@@@
...@@@..@@@..@@@...@@...@@@@@@@...@@@@@@@@..@@@...@@@@@@@...@@@@@@@@@@@@@@@@@@@@
...@@@..@@@..@@@...@@...@@@@@@@...@@@@@@@@..@@@...@@@@@@@...@@@@@@@@@@@@@@@@@@@@
...@@@..@@@..@@@...@@...@@@@@@@...@@@@@@@@..@@@...@@@@@@@...@@@@@@@@@@@@@@@@@@@@
........@@@........@@........@@............................................@@@@@
........@@@........@@........@@............................................@@@@@
........@@@........@@........@@............................................@@@@@
@@@@@@..@@@@@@@@@@@@@@@@@@...@@@@@@@@@@@@@@@@@@@@@@@...@@...@@@@@@@@@@@@@..@@@@@
@@@@@@..@@@@@@@@@@@@@@@@@@...@@@@@@@@@@@@@@@@@@@@@@@...@@...@@@@@@@@@@@@@..@@@@@
...@@@.............@@...@@..................@@@........@@...@@........@@@..@@@@@
...@@@.............@@...@@..................@@@........@@...@@........@@@..@@@@@
...@@@.............@@...@@..................@@@........@@...@@........@@@..@@@@@
...@@@@@@@@..@@@@@@@@...@@@@@@@@@@@@@@@@@@..@@@@@@@@@@@@@@@@@@@@@@@@..@@@..@@@@@
...@@@@@@@@..@@@@@@@@...@@@@@@@@@@@@@@@@@@..@@@@@@@@@@@@@@@@@@@@@@@@..@@@..@@@@@
........@@@.............@@........................@@........@@.............@@@@@
........@@@.............@@........................@@........@@.............@@@@@
........@@@.............@@........................@@........@@.............@@@@@
...@@@..@@@..@@@@@@@@@@@@@...@@@@@@@@@@@@@@@@@@@@@@@...@@@@@@@...@@@@@@@@..@@@@@
...@@@..@@@..@@@@@@@@@@@@@...@@@@@@@@@@@@@@@@@@@@@@@...@@@@@@@...@@@@@@@@..@@@@@
...@@@..@@@.............@@........................@@...@@...@@...@@@..@@@..@@@@@
...@@@..@@@.............@@........................@@...@@...@@...@@@..@@@..@@@@@
...@@@..@@@.............@@........................@@...@@...@@...@@@..@@@..@@@@@
...@@@@@@@@@@@@@...@@@@@@@@@@@@@@@@@@@@@@@@@@@@...@@...@@...@@...@@@..@@@@@@@@@@
...@@@@@@@@@@@@@...@@@@@@@@@@@@@@@@@@@@@@@@@@@@...@@...@@...@@...@@@..@@@@@@@@@@
...@@@@@@@@@@@@@...@@@@@@@@@@@@@@@@@@@@@@@@@@@@...@@...@@...@@...@@@..@@@@@@@@@@
........@@@........@@.............@@@.............@@........@@...@@@.......@@@@@
........@@@........@@.............@@@.............@@........@@...@@@.......@@@@@
...@@@..@@@..@@@@@@@@...@@@@@@@...@@@..@@@@@@@@@@@@@@@@@@...@@...@@@@@@@@..@@@@@
...@@@..@@@..@@@@@@@@...@@@@@@@...@@@..@@@@@@@@@@@@@@@@@@...@@...@@@@@@@@..@@@@@
...@@@..@@@..@@@@@@@@...@@@@@@@...@@@..@@@@@@@@@@@@@@@@@@...@@...@@@@@@@@..@@@@@
...@@@.......@@@........@@........@@@.......@@@.............@@...@@@.......@@@@@
...@@@.......@@@........@@........@@@.......@@@.............@@...@@@.......@@@@@
...@@@@@@@@@@@@@...@@@@@@@@@@@@...@@@@@@@@..@@@...@@@@@@@@@@@@...@@@..@@@@@@@@@@
...@@@@@@@@@@@@@...@@@@@@@@@@@@...@@@@@@@@..@@@...@@@@@@@@@@@@...@@@..@@@@@@@@@@
...@@@@@@@@@@@@@...@@@@@@@@@@@@...@@@@@@@@..@@@...@@@@@@@@@@@@...@@@..@@@@@@@@@@
........@@@........@@........@@........@@@..@@@............................@@@@@
........@@@........@@........@@........@@@..@@@............................@@@@@
........@@@........@@........@@........@@@..@@@............................@@@@@
@@@@@@..@@@@@@@@...@@...@@...@@...@@@@@@@@..@@@@@@@@@@@@@@@@@@@@@@@@@@@@@..@@@@@
@@@@@@..@@@@@@@@...@@...@@...@@...@@@@@@@@..@@@@@@@@@@@@@@@@@@@@@@@@@@@@@..@@@@@
.............@@@...@@...@@...@@........@@@..................@@...@@@.......@@@@@
.............@@@...@@...@@...@@........@@@..................@@...@@@.......@@@@@
.............@@@...@@...@@...@@........@@@..................@@...@@@.......@@@@@
...@@@@@@@@@@@@@...@@...@@...@@@@@@@@..@@@..@@@@@@@@@@@@@...@@...@@@..@@@@@@@@@@
...@@@@@@@@@@@@@...@@...@@...@@@@@@@@..@@@..@@@@@@@@@@@@@...@@...@@@..@@@@@@@@@@
........@@@..@@@........@@...@@........@@@..@@@.............@@.............@@@@@
........@@@..@@@........@@...@@........@@@..@@@.............@@.............@@@@@
........@@@..@@@........@@...@@........@@@..@@@.............@@.............@@@@@
@@@@@@..@@@..@@@@@@@@@@@@@...@@@@@@@@..@@@@@@@@...@@@@@@@@@@@@@@@@@@@@@@@..@@@@@
@@@@@@..@@@..@@@@@@@@@@@@@...@@@@@@@@..@@@@@@@@...@@@@@@@@@@@@@@@@@@@@@@@..@@@@@
........@@@.......................@@@.......@@@.......................@@@..@@@@@
........@@@.......................@@@.......@@@.......................@@@..@@@@@
........@@@.......................@@@.......@@@.......................@@@..@@@@@
@@@@@@..@@@@@@@@...@@@@@@@...@@@@@@@@@@@@@..@@@@@@@@@@@@@...@@@@@@@@..@@@..@@@@@
@@@@@@..@@@@@@@@...@@@@@@@...@@@@@@@@@@@@@..@@@@@@@@@@@@@...@@@@@@@@..@@@..@@@@@
@@@@@@..@@@@@@@@...@@@@@@@...@@@@@@@@@@@@@..@@@@@@@@@@@@@...@@@@@@@@..@@@..@@@@@
...@@@.............@@...@@.............@@@..@@@........@@...@@........@@@..@@@@@
...@@@.............@@...@@.............@@@..@@@........@@...@@........@@@..@@@@@
...@@@@@@@@@@@@@@@@@@...@@@@@@@@@@@@@..@@@..@@@...@@@@@@@@@@@@...@@@@@@@@..@@@@@
...@@@@@@@@@@@@@@@@@@...@@@@@@@@@@@@@..@@@..@@@...@@@@@@@@@@@@...@@@@@@@@..@@@@@
...@@@@@@@@@@@@@@@@@@...@@@@@@@@@@@@@..@@@..@@@...@@@@@@@@@@@@...@@@@@@@@..@@@@@
.......................................@@@.......................@@@.......@@@@@
.......................................@@@.......................@@@.......@@@@@
@@@@@@@@@@@@@@@@@@@@@@@@@@@@@@@@@@@@@@@@@@@@@@@@@@@@@@@@@@@@@@@@@@@@@@@@@@@@@@@@
@@@@@@@@@@@@@@@@@@@@@@@@@@@@@@@@@@@@@@@@@@@@@@@@@@@@@@@@@@@@@@@@@@@@@@@@@@@@@@@@
@@@@@@@@@@@@@@@@@@@@@@@@@@@@@@@@@@@@@@@@@@@@@@@@@@@@@@@@@@@@@@@@@@@@@@@@@@@@@@@@
@@@@@@@@@@@@@@@@@@@@@@@@@@@@@@@@@@@@@@@@@@@@@@@@@@@@@@@@@@@@@@@@@@@@@@@@@@@@@@@@
@@@@@@@@@@@@@@@@@@@@@@@@@@@@@@@@@@@@@@@@@@@@@@@@@@@@@@@@@@@@@@@@@@@@@@@@@@@@@@@@
