type octile
height 63
width 55
map
TTTTTTTTTTTTTTTTTTTTTTTTTTTTTTT@TTTTTTTTTTTTTTTTTTTTTTT
T.............................T@T.....................T
T.............................T@T.....................T
T.............................T@T.....................T
T.............................T@T.....................T
T.............................T@T.....................T
T.............................T@T.....................T
T.............................T@T.....................T
T.............................T@T.....................T
T.............................T@T.....................T
T.............................T@T.....................T
T.............................T@T.....................T
T.............................T@T.....................T
T.............................TTT.....................T
T.....................................................T
T.....................................................T
T.....................................................T
T.............................TTT.....................T
T.............................T@T.....................T
T.............................T@T.....................T
T.............................T@T.....................T
T.............................T@T.....................T
T.............................T@T.....................T
T.............................T@T.....................T
T.............................T@T.....................T
T.............................T@T.....................T
T.............................T@T.....................T
T.............................T@T.....................T
T.............................T@T.....................T
T.............................T@T.....................T
T.............................T@TTTTTTTTTTTTTTTTTTTTTTT
T.............................T@@@@@@@@@@@@@@@@@@@@@@@@
T.............................T@TTTTTTTTTTTTTTTTTTTTTTT
T.............................T@T.....................T
T.............................T@T.....................T
T.............................T@T.....................T
T.............................T@T.....................T
T.............................T@T.....................T
T.............................T@T.....................T
T.............................T@T.....................T
T.............................T@T.....................T
T.............................T@T.....................T
T.............................T@T.....................T
T.............................T@T.....................T
T.............................T@T.....................T
T.............................TTT.....................T
T.....................................................T
T.....................................................T
T.....................................................T
T.............................TTT.....................T
T.............................T@T.....................T
T.............................T@T.....................T
T.............................T@T.....................T
T.............................T@T.....................T
T.............................T@T.....................T
T.............................T@T.....................T
T.............................T@T.....................T
T.............................T@T.....................T
T.............................T@T.....................T
T.............................T@T.....................T
T.............................T@T.....................T
TTTTTTTTTTTTTTTTTTTTTTTTTTTTTTT@T.....................T
@@@@@@@@@@@@@@@@@@@@@@@@@@@@@@@@TTTTTTTTTTTTTTTTTTTTTTT
