type octile
height 31
width 30
map
@@@@@@@@@@@@@@T@T@@@@@@@@@@@@@
@@@@@@@@@@@@@@@@@T@@@@@@@@@@@@
@@@TTTTTTTT@TTTTTTTTT@@@@@@@@@
@@@TTTTTTTT@TTTTTTTTT@@@@@@@@@
@TTTTTTT..TT..TTTTT@@@@@@TTTT@
T@TTT.........TTT@TTT@@@TTTT@T
@@TTT...........T@TTT@@@TTTT@@
T@TTTT...........TT....TTTTT@@
@@@TTT...........TT.......TT@T
@@TTTT.....................TT@
@@@TTT.....................T@@
@@@TTT.....................T@@
@@@TTTT................TTTTT@@
@@@TTTTT.............TTTTTTT@@
@@@TTTTT..........TTTTTTTT@TT@
@@@TTTTT..........TTTTTTT@TTT@
@@@TTTT...........TTTTTTT@TT@@
@@@TTT............TTTTTTT@TT@@
@@@TTT............TTTT@@@@TT@@
@@@TTT............TTTT@@@@TT@@
@@TTTT............TTTT@@@@TT@@
@T@TTT............TTTT@@@@@T@@
@T@TTT............TTTT@@T@@T@@
@T@TTT............TTTT@TT@TTT@
@@@TTT............TTTT@TTTTTT@
@@@TTTT...........TTTT@@TTTT@@
@@@TTTT.........TTTTTT@@@@TT@@
@@@TT...........TTTTTTTTT@TT@@
@@@TT....TTT.TTTTTTTTTTTTTTT@@
@@@TTT...TTTTTTTTTTTTTTTTTTT@@
@@@TTT...TTTTTTTTTTTTTTTTTTT@@
