type octile
height 124
width 129
map
@@@@@@@@@@@@@@@@@@@T@@@@@@@@@@@@@@@@@@@@@@@@@@@@@@@@@@@@@@@@@@@@@@@@@@@@@@@@@@@@@@@@@@@@@@@@@@@@@@@@@@@@@@@@@@@@@@@@@@@@@@@@@@@@@
@@@@@@@@@@@@@@@@@@TT@@@@@@@@@@@@@@@@@@@@@@@@@@@@@@@@@@@@@@@@@@@@@@@@@@@@@@@@@@@@@@@@@@@@@@@@@@@@@@@@@@@@@@@@@@@@@@@@@@@@@@@@@@@@@
@@@@@@@@@@@@@@@@@TTT@@@@@@@@@@@@@@@@@@@@@@@@@@@@@@@@@@@@@@@@@@@@@@@@@@@@@@@@@@@@@@@@@@@@@@@@@@@@@@@@@@@@@@@@@@@@@@@@@@@@@@@@@@@@@
@@@@@@@@@@@@@@@@T@TT@@@@@@@@@@@@@@@@@@@@@@@@@@@@@@@@@@@@@@@@@@@@@@@@@@@@@@@@@@@@@@T@TTTTT@@@@@@@@@@@@@@@@@@@@@@@@@@@@@@@@@@@@@@@@
@@@@@@@@@@@@TTTTTTTTTTTTTTTTTTTTT@@@@@@@@@@@@@@@@@@@@@@@@@@@@@@@@@@@@@@TT@T@@@TTTTTTTTTTTT@T@@@@@@@@@@@@@@@@@@@@@@@@@@@@@@@@@@@@@
@@@@@@@@@@@@TTTTTTTTTTTTTTTTTTTTT@@@@@@@@@@@@@@@@@@@@@@@@@@@@@@@@@@@@@@TTTT@@TTTT@TTTTTTTTT@T@@@@@@@@@@@@@@@@@@@@@@@@@@@@@@@@@@@@
@@@@@@@@@@@@TTTTTTTTTTTTTTTTTTTTTT@@@@@@@@@@@@@@@@@@@@@@@@@@@@@@@@@@@T@@T@@@TTTT@@T@@@TTTTTT@@@@@@@@@@@@@@@@@@@@@@@@@@@@@@@@@@@@@
@@@@@@@@@@@@TTTTTTTTTTTTTTTTTTTTTTT@@@@@@@@@@@@@@@@@@@@@@@@@@@@@@@@@@@T@@TTTTT@@@TTTTTTTTTT@@@@@@@@@@@@@@@@@@@@@@@@@@@@@@@@@@@@@@
@@@@TTTTTTTTTTTTTTTTTTTTTTTTTTTTTTTT@@@@@@@@@@@@@@@@@@@@@@@@@@@@@@@@TTTTTT@TT@T@@@@TTTTTTTTT@@@@@@@@@@@@@@@@@@@@@@@@@@@@@@@@@@@@@
@@@@TTTTTTTTTTTTTTTT@@@@TTTTTTTTTTTTT@@@@@@@@@@@@@@@@@@@@@@@@@@@@@@@TTTTT@@TT@@@@@@TTTTTTTTTTT@TT@@@@@@@@@@@@@@@@@@@@@@@@@@@@@@@@
@@@@TTTTTTTTTTTTTT@@@@@@@TTTTTTTTTTTTT@@@@@@@@@@@@@@@@@@@@@@@@@@@@@@T@TT@@TT@@@@@@@TTTTTTTTTT@TT@@@@@@@@@@@@@@@@@@@@@@@@@@@@@@@@@
@@@@TTTTTTTTTTTTT@@@@@@@@@@TTTTTTTTTTTT@@@@@@@@@@@@@@@@@@@@@@@@@@@@@@@@@@@T@@@@@@@@TTTTTTTTTTTTTTTT@@@@@@@@@@@@@@@@@@@@@@@@@@@@@@
@@@@TTTTTTTTTTTTTTTTTTTTTT@@TTTTTTTTTTTT@@@@@@@@@@@@@@@@@@@@@@@@@@@@@@@@TTT@@@@@@@TTTTTTTTTTTTTTTTTT@T@@@@@@@@@@@@@@@@@@@@@@@@@@@
@@@@TTTTTTTTTTT@TTTTT@@@TTTTTTTTTTTTTT@T@@@@@@@@@@@@@@@@@@@@@@@@@@@@@@@@T@TTTTT@TTTTTTTTTTTT@@@TTTTTTTT@@@@@@@@@@@@@@@@@@@@@@@@@@
@@@@TTTTTTTTTTTTTTTT@@@@@TTTTTTTT@TTTTTTTT@@@@@@@@@@@@@@@@@@@@@@@@@@@@@@@TTTTTTTT...TTTTTTTT@@@@TTTTTTTT@@@@@@@@@@@@@@@@@@@@@@@@@
@@@@TTTTTTTTTTTTT@T@@@@@@@TTTTT@@@TTT@@TTTT@@@@@@@@@@@@@@@@@@@@@@@@@@@@T@TTTTTTTTT...TTTTTTT@@@@@@@TTTT@@@@@@@@@@@@@@@@@@@@@@@@@@
@@@@TTTTTTTTTTTTTT@@@@@@@TTTTTTT@@TT@@@@@@@@@@@@@@@@@@@@@@@@@@@@@@@@@@@TTTTTTTTTTT........T@TTTT@@@@TTTTT@@@@@@@@@@@@@@@@@@@@@@@@
@@@@TTTTTTTTTTTT@@@@@@@TTTTTTTTT@@@T@@@@@@@@@@@@@@@@@@@@@@@@@@@@@@@@@@@TTTTTTTTTTT........TTTTTT@@@@@TTT@@@@@@@@@@@@@@@@@@@@@@@@@
@@@@TTTTTTTTTTT@@@@@@@TTT@@@@TTTT@TT@@@@@@@@@@@@@@@@@@@@@@@@@@@@@@@@@@@TTTTTTTTTTT.......TTTTTTTT@@@@TTT@@@@@@@@@@@@@@@@@@@@@@@@@
@@@@TTTTTTTTTTT@@@@@@TTT@T@@@@TT@TTT@@@@@@@@@@@@@@@@@@@@@@@@@@@@@@@@@@@@TTTTTTTTTT.......T@TT@TTT@@@@TT@@@@@@@@@@@@@@@@@@@@@@@@@@
@@@@TTTTTTTTTT@@@@@@TTT@@@TT@TTTTTTTT@@@@@@@@@@@@@@@@@@@@@@@@@@@@@@@@@@@TTTTTTTTTT......TTT@T@@@T@@@TTT@@@@@@@@@@@@@@@@@@@@@@@@@@
@@@@TTTTTTTTTT@@@@@TT@@@@@T@@@TTTTTTT@@T@@@@@@@@@@@@@@@@@@@@@@@@@@@@@@@@@TTTTTTTT.......TTT@@@@@@@TTTTT@@@@@@@@@@@@@@@@@@@@@@@@@@
@@@@TTTTTTTT@@@@@@@@@@@@@@@@@@TTTTTTT@TT@@@@@@@@@@@@@@@@@@@@@@@@@@@@@@@@@@TTTTT..........T@T@@@@@TTTTTT@@@@@@@@@@@@@@@@@@@@@@@@@@
@@@@TTTTTTTTTT@@@@@TTT@@@@@@@TTTTTTTTTT@@@@@@@@@@@@@@@@@@@@@@@@@@@@@@@@@@@TT@@TT.........TTTT@@@@TTTTTT@@@@@@@@@@@@@@@@@@@@@@@@@@
@@@@TTTTTTTTTT@@@@@TTTTTTTTTTTTTTTT@@@T@@@@@@@@@@@@@@@@@@@@@@@@@@@@@@@@@@@TTT@@TT.........TTT@@@@TTTTTTT@@@@@@@@@@@@@@@@@@@@@@@@@
@@@@TTTTTTTTTTT@@@@@@@TTTTTTTTTTTTTT@@@@@@@@@@@@@@@@@@@@@@@@@@@@@@@@@@@@@@@TT@@TTT.........TT@@TTTTTTTTT@@@@@@@@@@@@@@@@@@@@@@@@@
@@@@TTTTTTTTTTTTT@@@@@@@@@@TTTTT@T@T@@@@@@@@@@@@@@@@@@@@@@@@@@@@@@@@@@@@@@@TTT@@@T..........T@TTTTTTTTTT@@@@@@@@@@@@@@@@@@@@@@@@@
@@@@TTTTTTTTTTTTTTTT@@@@@@@TTTTTT@@TT@T@@@@@@@@@@@@@@@@@@@@@@@@@@@@@@@@@@@@@TT@@@T..........TTTTTTTTTTTT@@@@@@@@@@@@@@@@@@@@@@@@@
@@@@TTTTTTTTTTTTTTTTTTT@@T@TTTTTTTTT@@@@@@@@@@@@@@@@@@@@@@@@@@@@@@@@@@@@@@@@TT@@@T..........TTTTTTTTTTTTT@@@@@@@@@@@@@@@@@@@@@@@@
@@@@TTTTTTT@@@TTT@@TTTTTTTTTTTTTTTTT@@@@@@@@@@@@@@@@@@@@@@@@@@@@@@@@@@@@@@@@TT@@@TT.........TT@TTTTTTTTTT@@@@@@@@@@@@@@@@@@@@@@@@
@@@@TTTTTTT@@@@@@@@@T@TTTTTTTTTTTTTT@@@@@@@@@@@@@@@@@@@@@@@@@@@@@@@@@@@@@@@@T@TT@TT........TTT@@@@TTTTTTT@@@@@@@@@@@@@@@@@@@@@@@@
@@@@TTTTTT@@@@@@@@@@@TTTTTTTTTTTT@@@@@@@@@@@@@@@@@@@@@@@@@@@@@@@@@@@@@@@@@@@@@TT@TTT.......TTT@@@@TTTTTTTT@@@@@@@@@@@@@@@@@@@@@@@
@@@@TTTTT@@@@@@@@@@@@@TTTTT@@TT@TTTT@@@@@@@@@@@@@@@@@@@@@@@@@@@@@@@@@@@@@@@@@TTTTT@T.......TTT@@@@TTTTTTTT@@@@@@@@@@@@@@@@@@@@@@@
@@@@@TTTTT@@@@@@@@@@@@@T@TTTT@@TTTT@@@@@@@@@@@@@@@@@@@@@@@@@@@@@@@@@@@@@@@@@@@@TTT@T.......TTT@@@@TTTTTTTT@@@@@@@@@@@@@@@@@@@@@@@
@@@@@@TTT@@@@@@@@@@@@@@T@@@T@@T@TT@@@@@@@@@@@@@@@@@@@@@@@@@@@@@@@@@@@@@@@@@@@@@TTTTT.......TTTT@@@TTTTTTTT@@@@@@@@@@@@@@@@@@@@@@@
@@@@@@@T@@@@@@@@@@@@@@@T@@@@TTTTT@@@@@@@@@@@@@@@@@@@@@@@@@@@@@@@@@@@@@@@@@@@@@@@TTTTT.......TTTT@@TTTTTTTT@@@@@@@@@@@@@@@@@@@@@@@
@@@@@@@@@@T@@@@@@@@@@@@@@@@@@@@@@@@@@@@@@@@@@@@@@@@@@@@@@@@@@@@@@@@@@@@@@@@@@@@@TTTTT........TTTTTTTTTTTT@@@@@@@@@@@@@@@@@@@@@@@@
@@@@@@@@@T@@@@@@@@@@@@@@@@@@@@@@@@@@@@@@@@@@@@@@@@@@@@@@@@@@@@@@@@@@@@@@@@@@@@@@TTT@TTTT.....T@TTTTTTTTTT@@@@@@@@@@@@@@@@@@@@@@@@
@@@@@@@@@@@T@@@@@@@@@@@@@@@@@@@@@@@@@@@@@@@@@@@@@@@@@@@@@@@@@@@@@@@@@@@@@@@@@@@@TT@@TTTTT....TT@@@TTTTT@@@@@@@@@@@@@@@@@@@@@@@@@@
@@@@@@@@@@@T@@@@@@@@@@@@@@@@@@@@@@@@@@@@@@@@@@@@@@@@@@@@@@@@@@@@@@@@@@@@@@@@@@@TTTTTTTTTTT....T@@@TTTT@@@@@@@@@@@@@@@@@@@@@@@@@@@
@@@@@@@@@@@@@@@@@@@@@@@@@@@@@@@@@@@@@@@@@@@@@@@@@@@@@@@@@@@@@@@@@@@@@@@@@@@@T@@@TTT@@T@@TT....T@@@TTT@@@@@@@@@@@@@@@@@@@@@@@@@@@@
@@@@@@@@@@@@T@@@@@@@@@@@@@@@@@@@@@@@@@@@@@@@@@@@@@@@T@T@T@@@@@@@@@@@@@@@@@@@@@TTTT@@@TTTTT....T@@TTT@@@@@@@@@@@@@@@@@@@@@@@@@@@@@
@@@@@@@@@@@@TT@@@@@@@@@@@@@@@@@@@@@@@@@@@@@@@@@@@@@@@T@T@@T@@@@@@@@@@@@@@@@TTTTTT@@@@TTTT.....T@@TTT@@@@@@@@@@@@@@@@@@@@@@@@@@@@@
@@@@@@@@@@@@TTT@@@@@@@@@@@@@@@@@@@@@@@@@@@@@@@@@@@@@T@T@T@@@@@@@@@@TTTTT@TTTTTTT@@@@@TTTT.....T@@T@@@@@@@@@@@@@@@@@@@@@@@@@@@@@@@
@@@@@@@@@@@@@@@@@@@@@@@@@@@@@@@@@@@@@@@T@@@TTTTTTTTTTTTTTT@@@@@@@@@@TTTTTTTTTTT@@@@TTT........T@@@@@@@@@@@@@@@@@@@@@@@@@@@@@@@@@@
@@@@@@@@@@@@@@@@@@@@@@@@@@@@@@@@@@@@@@TT@@TTTTTTTTTTTTTTTTTTTT@@@@@@TTTTTTTTT@@@@@TT..........TT@@@@@@@@@T@@@@@@@@@@@@@@@@@@@@@@@
@@@@@@@@@@@@@@@@@@@@@@@@@@@@@@@@@@@@@TTT@TTTTTTTTTTTTTTTTTTTTTTT@@@TTTTTTT@@@@@@@@T............T@@@@@@@@@@TT@@@@@@@@@@@@@@@@@@@@@
@@@@@@@@@@@@@@@@@@@@@@@@@@@@@@@@@@@@TTTTTTTTTTTTTTTTTTTTTTTTTTTTTTTTTTT@T@@@@@@@@@T............T@@@@@@@@@@@TT@@@@@@@@@@@@@@@@@@@@
@@@@@@@@@@@@@@@@@@T@@@@@@@@@@@@@TTTTTTTTTTTTTTTTTTTTTTTTTTTTTTTTTTTT@@@@@TTTT@@@@@T............T@@@@@@@@@@@@@@@@@@@@@@@@@@@@@@@@@
@@@@@@@@@@@@@@@@@T@@@@@@@@@@T@@TTTTTTTTTTTTTTTTTTTTTTTTTTTTTTTTTTTTT@@@TTTTTTTT@T@TT...........TT@@@@@@@T@@@@@@@@@@@@@@@@@@@@@@@@
@@@@@@@@@@@@@@@@T@@@@@@@@@@@@T@@TTTTTTTTTTTTTTTTTTTTTTTTTTTTTTTTTTT@@T@TTTTTTTTTTT@TT...........T@@@@@@@@@@@@@@@@@@@@@@@@@@@@@@@@
@@@@@@@@@@@@@@@@@@@@@@@@@@@@T@@@TTTTTTTTTTTTTTTTTTTTTTTTTTTTTTTTTTT@@@@TTTTTTTTTTT@@TT..........T@@@@@@@@@@@@@@@@@@@@@@@@@@@@@@@@
@@@@@@@@@@@@@@@@@@@@@@@@@@@@@@@TTTTTTTTTTTTTTTTT@TTTTTTTTTTTTTT@TT@TTTTTTTTTTTTTTTTTTTT.........T@TTT@@@@@@@@@@@@@@@@@@@@@@@@@@@@
@@@@@@@@@@@@@@TT@@@@@@@@@@@@@@TTTTTTTTTTTTTTTTTT@@TTTTTTTTTTTT@@@@TT...TTTTTTTTTTTTTTTTT........TTT@T@@@@@@@@@@@@@@@@@@@@@@@@@@@@
@@@@@@@@@@@@@@@T@@@@@@@@@@@@@@TTTTTTTTTTTTTTTTTTT@TTTTTTTTTTTTT@@TT.....TTTTTTTTTTTTTTTT........TTT@T@@@@@@@@@@@@@@@@@@@@@@@@@@@@
@@@@@@@@@@@@@T@TT@@@@@@@@@@@@TTTTTTT@@TTT@@TTTTTT@@TTTTTTTTTTTT@@T.......TTTTTTTTTTTTTTT........TT@@TT@@T@@@@@@@@@@@@@@@@@@@@@@@@
@@@@@@@@@@@TTTTTTTTTTTTT@@@@@TTTTTT@@@@@@@@@TTTT@@@TTTTTTTTTTTTT@T............TTTTTTTTTTT........T@@@@@@@@@@@@@@@@@@@@@@@@@@@@@@@
@@@@@@@@@@TTTTTTTTTTTTT@@@@@@TTTTTT@@@@@@@@@@TTT@@@@TTTTTTTTTTTT@T............TTTTTTTTTTTT.......TT@@@@@@@@@@@@@@@@@@@@@@@@@@@@@@
@@@@@@@@@TTTTTTTTTTTTTT@@@@@TTTTTTT@@@@@@@@@@TTTT@@@TTTTTTTTTTTTTT.............TT@TTTTTTTTT......TT@@@@@@@@@@@@@@@@@@@@@@@@@@@@@@
@@@@@@@@TTTTTTTTTTTTTTT@T@@@TTTTTTT@@@TTTTTTTTTTTT@@TTTTTTTTTTTTTT..............TTTTTT@TTTT.....TTTTTTT@@@@@@@@@@@@@@@@@@@@@@@@@@
@@@@@@@TTTTTTTTTTTTTTT@@TTTTTTTTTTT@@TTTTTTTTTTTTTT@@TTTTTTTTTTTTT..............T@T@TT@@TTT.....TTTT@TTT@@@@@@@@@@@@@@@@@@@@@@@@@
@@@@@@TTTTTTTTTTTTTTTT@@@@@TTTTTTTT@@TTTTTTTTTTTTTTT@TTTTTTTTTTTTT..............TTTT@TTTTTTT....T@T@@@TT@@@@@@@@@@@@@@@@@@@@@@@@@
@@@@@@@TTTTTTTTTTTTT@@@@@@@TTTTTTTT@TTTTTTTTTTTTTTTTTTTTTTTTTTTTTT...............TTTTTTTTTTT....T@T@@@TT@@@@@@@@@@@@@@@@@@@@@@@@@
@@@@TTTTTTTTT@@@@@@@@@@@@@@@@TTTTTT@TTTTTTTTTTTTTTTTTTTTTTTTTTTTTTT..TTTT.......TTTTTT@TTTTT....T@T@@@TTT@@@@@@@@@@@@@@@@@@@@@@@@
@@@TTTTTTT@TTT@@@@@@@@@@@@@@@TTTTTTTTTTTTTTTTTTTTTTTTTTTTTTTTTTTTTT.TTTTTT......TTTTT@@@@@@T....T@T@@TTT@@@@@@@@@@@@@@@@@@@@@@@@@
@@TTTTTTTT@@TT@@@@@@@@@@@@@@@@TTTTTTTTTTTTTTTTTTTTTTTTTTTTTTTTTTTTTTTT@@TT.......TTTTTTTT@@T....T@TTTTTT@@@@@@@@@@@@@@@@@@@@@@@@@
@TTTTTTTTT@@@TT@@@@@@@@TTTTT@@TTTTTTTTTTTTTTTTTTTTTTTTTTTTTTTTTTTTT@@T@@TT...........TTTTTTT.....TT@TTT@@@@@@@@@@@@@@@@@@@@@@@@@@
TTT@TTTTTT@@@@@@@TTT@TTTTTTTT@TTTTTTTTTTTTTTTTTTTTTTTTTTTTTTTTTTT@TT@T@@TT........................TTTT@T@@@@@@@@@@@@@@@@@@@@@@@@@
TTT@@@@TTT@@@@@@TTTTTTTTTTTTTTTTTTTTTTTTTTTTTTTTTTTTTTTTTTTTTTTTT@@TTTTTT...........................T@@TTTTTT@@@@@@@@@@@@@@@@@@@@
TTT@@@@@TTT@@@@@TTTTTTTTTTTTTTTTTTTTTTTTTTTTTTTTTTTTTTTTTTTTTTTTTTT@TTTTTT...........................T@@T@@@TT@@@@@@@@@@@@@@@@@@@
TTT@@@@@@TT@@@@@TTTTTTTTTTTTTTTTTTTTTTTTTTTTTTTTTTTTTTTTTTTTTTTTTTT@@TT@@T.........TTT...............TT@@@@@@TT@@@@@@@@@@@@@@@@@@
TTT@@@@@@@@@@@@@TTTTTTTTTTTTTTTTTTTTTTTTTTTTTTTTTTTTTTTTT@@TTTTTTT@@@@T@@T........TTTTT................TT@@@@TT@@@@@@@@@@@@@@@@@@
TT@@@@@@@@@@@@@@TTTTTTTTTTTTTTTTTTTTTTTTTTTTTTTTTTTTTTTTT@@@@TTTTTT@@TT@@T.......TT@@@TTT...............TT@@@@TT@@@@@@@@@@@@@@@@@
TT@@@@@@@@@@@@@@@TTTTTTTTTTTTTTTTTTTTTTTTTTTTTTTTTTTTTTTT@@@@@TTTTTT@@TT@T......TTTTTTTTT................TTTT@@TT@@@@@@@@@@@@@@@@
T@@@@@@@@@@@@@@TTTTTTTTTTTTTTTTTTTTTTTTTTTTTTTTTTTTTTTTTT@@@@@@@TTTT@@TTTT......TTTTTTT@T...................TT@@T@T@@@@@@@@@@@@@@
@@@@@@@@@@@@@@@TTTTTTTTTTTTTTTTTTTTTTTTTTTTTTTTTTTTTTTTTT@@@@@@@@TTT@@TTTT......TTT@@TTTT....................TTT@TT@@@@@@@@@@@@@@
@@@@@@@@@@@@@@TTTTTTTTTTTTTTTTTTTTTTTTTTTTTTTTTTTTTTTTTTT@@@@@@@@@TT@@TTTTT.....TTT@@@TTT......................TT@T@@@@@@@@@@@@@@
@@@@@@@@@@@@@@TTTTTTTTTTTTTTTTTTTTTTTTTTTTTTTTTTTTTTTTTTT@@@@@@@@@TT@@@@@@T.....TTT@@TTTT.......................TT@@@@@@@@@@@@@@@
@@@@@@@@@@@@@TTTTTTTTTTTTTTTTTTTTTTTTTTTTTTTTTTTTTTTTTTTTT@@@@@@@TTTT@@@@@T.....TTTTTTTT.........................TTT@@@@@@@@@@@@@
@@@@@@@@@@@@@TTTTTTTTTTTTTTTTTTTTTTTTTTTTTTTTTTTTTTTTTTTT@T@@@@@@@TT@@@@@@T......TTTTTTT....TTTTTTT...............TTT@@@@@@@@@@@@
@@@@@@@@@@@@@TTTTTTTTTTTTTTTTTTTTTTTTTTTTTTTTTTTTTTTTTTTT@T@@@@@@@TT@@@@@@T........TTTT....TTTTTTTTTTTTTT..........TT@@@@@@@@@@@@
@@@@@@@@@@@@@TTTTTTTTTTTTTTTTTTTTTTTTTTTTTTTTTTTTTTTTTTTT@T@@@@@@TTT@@@@TTT................TT@@@@TT@TT@@TT.........TT@@@@@@@@@@@@
@@@@@@@@@@@@@TTTTTTTTTTTTTTTTTTTTTTTTTTTTTTTTTTTTTTTTTTTT@T@@@@@TTTT@@@@TT.................TT@@@@TT@T@@@@TT.......TTT@@@@@@@@@@@@
@@@@@@@@@@@@@TTTTTTTTTTTTTTTTTTTTTTTTTTTTTTTTTTTTTTTTTTTTTT@@@@TTTTT@@@@TT........TTTT.....T@@@@@TT@T@@@@TT......TT@T@@@@@@@@@@@@
@@@@@@@@@@@@@TTTTTTTTTTTTTTTTTTTTTTTTTTTTTTTTTTTTTTTTTTTTTT@TT@@TTTT@@@@@TTTTT...TT@@TTT...TTTTTTTT@@T@@@TTTTTT.TT@@TT@@@@@@@@@@@
@@@@@@@@@@@@@@TTTTTTTTTTTTTTTTTTTTTTTTTTTTTTTTTTTTTTTTTTTT@TT@@@TTTT@@@@@@@TTTTTTTTT@@@TTT.TTT@@TT@@@TTT@TTTT@TTT@TTTT@@@@@@@@@@@
@@@@@@@@@@@@@@TTTTTTTTTTTTTTTTTTTTTTTTTTTTTTTTTTTTTTTTTTT@@@@@@@T@@@TTT@@@TTTTTTTTT@@@@@@TTT@@@@@@T@TTTTTT@@@@@@TTTTTT@@@@@@@@@@@
@@@@@@@@@@@@@@@TTTTTTTTTTTTTTTTTTTTTTTTTTTTTTTTTTTTTTTTT@@@@@@@@TTTTTTT@@@@TTT@@@@@T@@@@@@@T@@@@@@TTTTTTTTTTTTTTTTTTT@@@@@@@@@@@@
@@@@@@@@@@@@@@@TTTTTTTTTTTTTTTTTTTTTTTTTTTTTTTTTTTTTTTTTTTTT@@@@@TTTTT@@@@@@@@@@@@@T@@@@T@@@@@@@@TTTTTTTTTTTTTTTTTTTT@@@@@@@@@@@@
@@@@@@@@@@@@@@@@TTTTTTTTTTTTTTTTTTTTTTTTTTTTTTTTTTTTTTTTTTTTTTTTT@TTTT@@@@@@@@@@@@@@T@@@T@@@@@@TTTTTTTTTTTTTTTTTTTTT@@@@@@@@@@@@@
@@@@@@@@@@@@@@@@TTTTTTTTTTTTTTTTTTTTTTTTTTTTTTTTTTTTTTTTTTTTTTTTTTTTTT@@@@@@@@@@@@@@@TTTT@@@@@TTTTTTTTTT@T@TTTTTTTT@@@@@@@@@@@@@@
@@@@@@@@@@@@@@@@TTTTTTTTTTTTTTTTTTTTTTTTTTTTTTTTTTTT@TTTTTTTTTTTTTTTTTTTTT@@TT@@T@@@@@@@T@@@@@TTTTTTTT@@@@@@@@@TT@@@@@@@@@@@@@@@@
@@@@@@@@@@@@@@@@TTTTTTTTTTTTTTTTTTTTTTTTTTTTTTTTTTT@TTTTTTTTTTTTTTTTTTTTTTTTTTTTTT@@@@@T@@@@@TTTTTTT@@@@@@@@@@@@@@@@@@@@@@@@@@@@@
@@@@@@@@@@@@@@@@@TTTTTTTTTTTTTTTTTTTTTTTTTTTTTT@@@@@TTTTTTTTTTTTTTTTTTTTTTTTTTTTTTT@@@TT@@@TTTTTTT@@@@@@@@@@@@@@@@@@@@@@@@@@@@@@@
@@@@@@@@@@@@@@@@@TTTTTTTTTTTTTTTTTTTTTT@@@@@@@@@@@@@TTTTTTTTTTTTTTTTTTTTTTTTTTTTTT@@@@TTTTTTTTT@@@@@@@@@@@@@@@@@@@@@@@@@@@@@@@@@@
@@@@@@@@@@@@@@@@@@TTTTTTTTTTTTTTTTTTTT@@@@@@@@@@@@@@TTTTTTTTTTTTTTTTTTTTTTTTTTTTTT@@@@@TTTTTTTT@@@@@@@@@@@@@@@@@@@@@@@@@@@@@@@@@@
@@@@@@@@@@@@@@@@@@TTTTTTTTTTTTTTTTTTTT@@TTTTTTT@@@@TTTTTTTTTTTTTTTTTTTTTTTTTTTT@@@@@@@TTTTTTTT@@@@@@@@@@@@@@@@@@@@@@@@@@@@@@@@@@@
@@@@@@@@@@@@@@@@@@@TTTTTTTTTTTTTTTTTT@@@TTTTTTTTT@@TTTTTTTTTTTTTTTTTTTTTTTTTTTT@@@@@@@TTTTTTT@@@@@@@@@@@@@@@@@@@@@@@@@@@@@@@@@@@@
@@@@@@@@@@@@@@@@@@@@TTTTTTTTTTTTTTTTTT@TTTTTTTTTTTT@@TTTTTTTTTTTTTTTTTTTTTTTTT@@@@@@@@TTTTTTT@@@@@@@@@@@@@@@@@@@@@@@@@@@@@@@@@@@@
@@@@@@@@@@@@@@@@@@@@@@TTTTTTTTTTTTTTTTTTTTTTTTTTTTT@@@@@@@TTTTTTTTTTTTTTTTTTTT@@@@@@@@@@TTTTTT@@@@@@@@@@@@@@@@@@@@@@@@@@@@@@@@@@@
@@@@@@@@@@@@@@@@@@@@@@@@@@@@TTTTTTTTTTTTTTTTTTTTTTTT@@@@@@@@@@TTTTTTTTTTTTTTTT@@@@@@@@@@TTTTT@@@@@@@@@@@@@@@@@@@@@@@@@@@@@@@@@@@@
@@@@@@@@@@@@@@@@@@@@@@@@@@@@@TTTTTTTTTTTTTTTTTTTTTTTT@@@@@@@@@@@@@@TTTTTTTTTTT@@@@@@@@@@TTTTTT@@@@@@@@@@@@@@@@@@@@@@@@@@@@@@@@@@@
@@@@@@@@@@@@@@@@@@@@@@@@@@@@@TTTTTTTTTTTTTTTTTTTTTTTTTT@TT@@@@@@@@@@@@@TTTTTT@@@@@@@@@@TTTTT@@@@@@@@@@@@@@@@@@@@@@@@@@@@@@@@@@@@@
@@@@@@@@@@@@@@@@@@@@@@@@@@@@TT@@@TTTTTTTTTTTTTTTTTTTTTTTTT@@@@@@@@@@@@@@@@@@T@@@@@T@@@@TTTTT@@@@@@@@@@@@@@@@@@@@@@@@@@@@@@@@@@@@@
@@@@@@@@@@@@@@@@@@@@@@@@@@@@@@@@@@@@@TTTTTTTTTTTTTTTTTTT@@@@T@T@@@@@@@@@@@@@@@@@@@@@TTTTTTTT@@@@@@@@@@@@@@@@@@@@@@@@@@@@@@@@@@@@@
@@@@@@@@@@@@@@@@@@@@@@@@@@@@@@@@@@@@@TTTTTTTTTTTTTTTTTTTT@@TTTTT@@@@@@@@@@@@@@@@@@@@TTTTTTTT@@@@@@@@@@@@@@@@@@@@@@@@@@@@@@@@@@@@@
@@@@@@@@@@@@@@@@@@@@@@@@@@@@@@@@@@@@@@TTTTTTTTTTTTTTTTTTTTT@TTTTTTTTTTT@@@@@@@@@@@@@@TTTTTTT@@@@@@@@@@@@@@@@@@@@@@@@@@@@@@@@@@@@@
@@@@@@@@@@@@@@@@@@@@@@@@@@@@@@@@@@@@@@TTTTTTTTTTTTTTTTTTTTTTTTTTTTTTTTT@@@@@@@@@@TTTTTTTTTTTT@@@@@@@@@@@@@@@@@@@@@@@@@@@@@@@@@@@@
@@@@@@@@@@@@@@@@@@@@@@@@@@@@@@@@@@@@@@@TTTTTTTTTTTTTTTTTTTTTTTTTTTTTTTTTT@@@@@@TTTTTTTTTTTTTT@@T@@@@@@@@@@@@@@@@@@@@@@@@@@@@@@@@@
@@@@@@@@@@@@@@@@@@@@@@@@@@@@@@@@@@@@@@@TTTTTTTTTTTTTTTTTTTTTTTTTTTTTTTTTTT@TTTTTTTTTTTTTTTTTTT@@@@@@@@@@@@@@@@@@@@@@@@@@@@@@@@@TT
@@@@@@@@@@@@@@@@@@@@@@@@@@@@@@@@@@@@@@@@TTTTTTTTTTTTTTTTTTTTTTTTTTTTTTTTTTTTTTTTTTTTTTTTTTTTTT@@@@@@@@@@@@@@@@@@@@@@@@@@@@@@@@TTT
@@@@@@@@@@@@@@@@@@@@@@@@@@@@@@@@@@@@@@@@@TTTTTTTTTTTTTTTTTTTTTTTTTTTTTTTTTTTTTTTTTTTTTTTTTTTTT@@@@@@@@@@@@@@@@@@@@@@@@@@@@@@@TTTT
@@@@@@@@@@@@@@@@@@@@@@@@@@@@@@@@@@@@@@@@@TTTTTTTTTTTTTTTTTTTTTTTTTTTTTTTTTTTTTTTTTTTTTTTTTTTTT@@@@@@@@@@@@@@@@@@@@@@@@@@@@@@TTTTT
@@@@@@@@@@@@@@@@@@@@@@@@@@@@@@@@@@@@@@@@@@TTTTTTTTTTTTTTTTTTTTTTTTTTTTTTTTTTTTTTTTTTTTTTTTTTTT@@@@@@@@@@@@@@@@@@@@@@@@@@@@@@TTTT@
@@@@@@@@@@@@@@@@@@@@@@@@@@@@@@@@@@@@@@@@@@TTTTTTTTTTTTTTTTTTTTTTTTTTTTTTTTTTTTTTTTTTTTTTTTTTTT@@@@@@@@@@@@@@@@@@@@@@@@@@@@@@TTTT@
@@@@@@@@@@@@@@@@@@@@@@@@@@@@@@@@@@@@@@@@@@@TTTTTTTTTTTTTTTTTTTTTTTTTTTTTTTTTTTTTTTTTTTTTTTTTTT@@@@@@@@@@@@@@@@@@@@@@@@@@@@@TTTTT@
@@@@@@@@@@@@@@@@@@@@@@@@@@@@@@@@@@@@@@@@@@@@TTTTTTTTTTTTTTTTTTTTTTTTTTTTTTTTTTTTTTTTTTTTTTTTTTT@@@@@@@@@@@@@@@@@@@@@@@@@@@@TTTTT@
@@@@@@@@@@@@@@@@@@@@@@@@@@@@@@@@@@@@@@@@@@@@@TTTTTTTTTTTTTTTTTTTTTTTTTTTTTTTTTTTTTTTTTTTTTTTTT@@@@@@@@@@@@@@@@@@@@@@@@@@@@@TTTTT@
@@@@@@@@@@@@@@@@@@@@@@@@@@@@@@@@@@@@@@@@@@@@@@TTTTTTTTTTTTTTTTTTTTTTTTTTTTTTTTTTTTTTTTTTTTTTTT@@@@@@@@@@@@@@@@@@@@@@@@@@@@@@TTTT@
@@@@@@@@@@@@@@@@@@@@@@@@@@@@@@@@@@@@@@@@@@@@@@@@@TTTTTTTTTTTTTTTTTTTTTTTTTTTTTTTTTTTTTTTTTTTT@@@@@@@@@@@@@@@@@@@@@@@@@@@@@@@TTTT@
@@@@@@@@@@@@@@@@@@@@@@@@@@@@@@@@@@@@@@@@@@@@@@@@@@TTTTTTTTTTTTTTTTTTTTT@@@@@@@@@@@@TTTTTTTT@@@@@@@@@@@@@@@@@@@@@@@@@@@@@@@@@@TTT@
@@@@@@@@@@@@@@@@@@@@@@@@@@@@@@@@@@@@@@@@@@@@@@@@@@@TTTTTTTTTTTTTTTTTTT@@@@@@@@@@@@@@@@@@@@@@@@@@@@@@@@@@@@@@@@@@@@@@@@@@@@@@@@@T@
@@@@@@@@@@@@@@@@@@@@@@@@@@@@@@@@@@@@@@@@@@@@@@@@@@@@@TTTTTTTTTTTTTTT@@@@@@@@@@@@@@@@@@@@@@@@@@@@@@@@@@@@@@@@@@@@@@@@@@@@@@@@@@@@@
@@@@@@@@@@@@@@@@@@@@@@@@@@@@@@@@@@@@@@@@@@@@@@@@@@@@@@@TTTTTTTTTT@@@@@@@@@@@@@@@@@@@@@@@@@@@@@@@@@@@@@@@@@@@@@@@@@@@@@@@@@@@@@@@@
