type octile
height 125
width 107
map
@@@@@@@@TTTT@@@@@@@@@@@@@@@@@@@@@@@@@@@@@@@@@@@@@@@@@@@@@@@@@@@@@@@@@@@@@@@@@@@@@@@@@@@@@@@@@@@@@@@@@@@@@@@
@@@@@@@@TTTT@@@@@@@@@@@@@@@@@@@@@@@@@@@@@@@@@@@@@@@@@@@@@@@@@@@@@@@@@@@@@@@@@@@@@@@@@@@@@@@@@@@@@@@@@@@@@@@
@@@@@@@@TTTT@@@@@@@@@@@@@@@@@@@@@@@@@@@@@@@@@@@@@@@@@@@@@@@@@@@@@@@@@@@@@@@@@@@@@@@@@@@@@@@@@@@@@@@@@@@TTT@
@@@@@@@@@@@@@@@@@@@@@@@@@@@@@@@@@@@@@@@@@@@@@@@@@@@@@@@@@@@@@@@@@@@@@@@@@@@@@@@@@@@@@@@@@@@@@@@@@@@@@@TT.T@
@@@@@@@@@@@@@@@@@@@@@@@@@@@@@@@@@@@@@@@@@@@@@@@@@@@@@@@@@@@@@@@@@@@@@@@@@@@@@@@@@@@@@@@@@@@@@@@@@@@@TT...TT
@@@@@@@@@@@@@@@@@@@@@@@@@@@@@@@@@@@@@@@@@@@@@@@@@@@@@@@@@@@@@@@@@@@@@@@@@@@@@@@@@@@@@@@@@@@T@@@@@@TTT.....T
@@@@@@@@@@@@@@@@@@@@@@@@@@@@@@@@@@@@@@@@@@@@@@@@@@@@@@@@@@@@@@@@@@@@@@@@@@@@@@@@@@@@@@@@@@@TTTTTTTT.......T
@@@@@@@@@@@@@@@@@@@@@@@@@@@@@@@@@@@@@@@@@@@@@@@@@@@TTT@@@@@@@@@@@@@@@@@@@@@@@@@@@@@@@@@@@TTT..............T
@@@@@@@@@@@@@@@@@@@@@@@@@@@@@@@@@@@@T@@@TTT@@@@@T@@TT@T@@@@@@@@@@@@@@@@@@@@@@@@@@@@@@@@@TT.................
@@@@@@@@@@@@@@@@@@@@@@@@@@@@@@@@@@@@@@@@@@TTTT@@TTTTTTT@@@TTTT@@@@@@@@@@@@@@@@@@@@@@@@TTT..................
@@@@@@@@@@@@@@@@@@@@@@@@@@@@TTTT@@@@TTTTTTTTTTT@T@@T@@@@@@TTTT@@@@@@@@@TTTTTTTTTTTTTTTT....................
@@@@@@@@@@@@T@@@@@@@@@@@@@@TTTTT@@@@T@@@@@@@@@@@@@@@@@@@@@TTTT@@TTTTTTTT...................................
@@@@@@@@@T@@@@@@TTT@T@@@@@@TTTT@@@@@@@@@@@@@@@@@@@@TTTTTTTTTTTTTT..........................................
@@@T@@@@TTT@@@TT@T@@TTTTTTTTT@@@@TTTTTTTTTTTTTTTTTTT..................................................T....
@@@TTT@@TTTTTTTTTTTTTTTTTTTTTTTTTT...................................................................TTTTTT
@@@T.TTTTTTTTTTTTT@@@TTTTTTT........................................................................TT@@@@T
@@@T...TTTTTTTTTT@TTTT............................................................................TTT@@@@@@
@@@T.....TTTTTTTTTT..............................................................................TT@@@@@@@@
@@@T.......TTTTT.................................................................................T@@@@@@@@@
@@@T.........T..................................................................................TT@@@@@@@@@
@@@T...........................................................................................TT@@@@@@@@@@
@@@T..........................................................................................TTTTTTT@@@@@@
@@@T.........................................................................................TTTTTTTT@@@@@@
@@@T.........................................................................................TTTTTTTT@@@@@@
@@@T........................................................................................TTTTTTTTT@@@@@@
@@@TTTTT...................................................................................TT@@@TTTT@@@@@@@
@@TTTTTTT..................................................................................T@@@TTTT@@@@@@@@
@TTTTTTTTT................................................................................TT@@@TTT@@@@@T@@@
@TTTTTTTTTT.TTT..........................................................................TT@@@@TTT@@@@@@@@@
TTTTTTTTTTTTT@TTTTT.....................................................................TTT@@@@TTT@@@@@@TT@
TTTTTTTTTTTT@@@@@@TT...................................................................TT@@@@@@TTTT@@@@@@@@
@TTTTTTTTTTT@@@@@@@TTT................................................................TT@@@@@@@TTT@@@@@@@@@
@TTTTTTTTTTT@TTTTTTTTTT..............................................................TT@@@@@@@@TT@@@@@@@@@@
@@TTTTTTTTTTTT@TTTT@TTTTT...........................................................TT@@@@@@@@TT@@@@@@@@@@@
@@@TTTTTTTT@TTTT@@@@@@@@TT........................................................TTT@@TTTTTTTTTTT@@@@@@@@@
@@@@@TTTTT@TT@@@@@@@@@@@@TTT.....................................................TT@@TTT@@@@@TTTTTTT@@T@@@@
@@@@@TTTTT@T@@@@@@@@@@@@@@TTT...................................................TT@@TTT@@@@@TTTTTTTTTTT@@@@
@@@@@@TTTT@T@@@@@@@@@@@@@@@TTT.................................................TT@TTT@@@@@@TTTTTTTTTTTT@@@@
@@@@@@TTTTTT@@@@@@@@@@@@@@@@TT.............................................TTTTTTTTT@@@@@@@TTTTTTTTTTTT@@@@
@@@@@@@TTTTT@@@@@@@@@@@@@@@@TT............................................TTTTTTTT@@@@@@@@@TTTTTTTTTTTT@@@@
@@@@@@TTTTTT@@@@@@@@@@@@@@@@TTT...........................................TTTTTTT@@@@@@@@@@TTTTTTTTTTTT@@@@
@@@@@@TTTTTT@@@@@@@@@@@@@@@@@TT............................................TTTTT@@@@@@@@@@@TTTTTTTTTTTT@@@@
@@@@@@TTTTTT@@@@@@@@@@@@@@@TTTTT............................................TTT@@@@@@@@@@@@TTTTTTTTTTTT@@@@
@@@@@@TTTTTT@@@@@@@@@@@TTTTTTT@T...........................................TTTT@@@@@@@@@@@TTTTTTTTTTTTT@@@@
@@@@@@TTTTTT@@@@@@@@@TTTTTTTTT@T...........................................T@TT@@@@@@@@@@@TTTT@TTTTT@T@@@@@
@@@@@@TTTTTT@@@@@@TTTTTTTTTTTTTT...........................................T@TT@@@T@@@@@@@TTTT@TTTT@@T@@@@@
@@@@@@TTTTTT@@TTTTTTTTTTTTTTTTT...........................................TT@TT@TTTTTTTTT@TTTT@TTTT@@T@@@@@
@@@@@@TTTTTT@TTTTTTTTTTTTTTT@@TTTTTTT.....................................T@@TTTTT@@TTTTTTTTTT@TTTTT@T@@@@@
@@@@@@TTTTTTTTTTTTTTTTTTTT@TTTTT@@@@TTTTTTTTTTT..........................TT@TTTT@@@TTTTTTTTTTT@TTTTTTT@@@@@
@@@@@@@TTTTTTTTTTTTTTTTTT@@@@T@@@@@@@@@@@@@@TTTT........................TTT@TTT@@@@TTTTTTTTTTT@@@TTTTT@@@@@
@@@@@@@TTTTT@TTTTTTTTTTTT@@@@@@@@@@@@@@@@@@@@@@T.......................TT@TTTTT@@@TTTTTTTTT@@@TT@TT@T@@@@@@
@@@@@@@TTTTT@@@TTTTTTTTTTT@@@@@@@@@@@@@@@@@@@@TT......................TT@@TTTTT@@TTTTTTTTTT@@@TTTTT@T@@@@@@
@@@@@@@TTTTT@@@@@TTTTTTT@@@@@@@@@@@@@@@@@@@@@@T......................TT@@@TTTT@@TTTTTT@TTTT@@@TTTTT@T@@@@@@
@@@@@@@TTTTT@@@@@@@@@@@@@@@@@@@@@@@@@@@@@@@@@TT.....................TT@@@TTTTT@TTTTTTT@TTTT@@@TTTTT@T@@@@@@
@@@@@@@@TTTT@@@@@@@@@@@@@@@@@@@@@@@@@@@@@@@@@T.............TTTT....TT@@@@TTTTTTTTTTTTTTTTT@@@@TTTTT@T@@@@@@
@@@@@@@TTTTT@@@@@@@@@@@@@@@@@@@@@@@@@@@@@@@@@T............TT@@T..TTTT@@@@TTTTTTTTTTTTTTTT@@@@@TTTT@@T@@@@@@
@@@@@@TTTTTT@@@@@@@@@@@@@@@@@@@@@@T@@@@@@@@@TT...........TT@@@TTTTTTT@@@TTTTTTTTTTTTTTTT@@@@@@TTTT@@T@@@@@@
@@@@@TTTTTTT@@@@@@@@@@@@@@@@@@@@@@@@@@@@@@@@T...........TT@@@TTTTTTTTTTTTTTTTTTTTTTTTTT@@@@@@@@TTT@@T@@@@@@
@@@@TTTTTTTT@@@@@@@@@@@@@@@@@@@@@T@@@@@@@@@TT.........TTT@@@TT@T@@TTTTTT@TTTTTTTTTTTTTT@@@@@@@TTTT@@T@@@@@@
@@@TTTTTTTTT@@@@@@@@@@@@@@@@@@@@@@@@@@@@@TTT..........T@@@@@@@@@@TTTTT@T@TTTTTTTTTTTTT@@@@@@@TTTTT@@T@@@@@@
@@TTTTTTTTTT@@@@@@@@@@@@@@@@@@T@@TTTTTTTTT...........TT@@@@@@@@@@TTTTTTTTTTTTTTTTTTTT@@@@@@@TTTTT@@@T@@@@@@
@TTTTTTTTTTT@@@@@@@@@@@@@TTTT@@TTT.....TT...........TT@@@@@@@@@@@TTTTTTTTTTTTTTTTTTT@@@@@@@TTTTT@@@@T@@@@@@
TTTTTTTTTTTT@@@@@@@@@@@@TTTTTTTT....................TT@@@@@@@@@@@TT@@@@TTTTTTTTTTTT@@@@@@@TT@TTT@@@TT@@@@@@
T@@@@@TTTTTT@@@@@@@@@@TTTTTT@TT......................T@@@@@T@@@@TT@@@@@@TTTTTT@TTTT@@@@@@TTTTTT@@@@T@@@@@@@
@@@@@TTTTTTT@@@@@@@@@TTTTTTT@T.......................T@@@@@TT@@@T@@@@@@@@@TTTT@TTTT@@@@@@TTTTT@@@@@T@@@@@@@
@@@@@@TTTTTT@@@@@@@@@TTTTTTTTT.......................T@@@@@TT@@@T@@@@@@@@@TTTT@TTTT@@@@@TTTTTT@@@@@T@@@@@@@
@@@@@@TTTTTT@@@@@@@@@TTTTT@TT........................T@@@T@TT@@@@@@@@@@@@@TTT@@TTTT@@@@@TTTTTTT@@@TT@@@@@@@
@@@@@@TTTTTT@@@@@@@@@TT@T@@T.........................T@@@@@TT@@@@@@@@@@@@TT@@@TTTTT@@@@@@@TTTTTT@@T@@@@@@@@
@@@@@@TTTTTT@@@@@@@@@TTTT@TT.........................T@@@TTTT@@T@@@@@@@@TT@@@TTTTTT@@@@@@@@TTTTTTTT@@@@@@@@
@@@@@@@TTTTT@@@@@@@@@TT@@@@T.........................T@@@TTT@@T@@@@@@@@TTT@@TTTTTTT@@@@@@@@TTTTTTTT@@@@@@@@
@@@@@@@TTTTTT@@@@@@@@TTT@@@T.........................T@T@TTTT@T@@@@@@@@TT@@TTTTTTTTT@@@@@@@TTTTTTT@@@@@@@@@
@@@@@@@TTTTTT@@@@@@@@TT@T@@T.........................TTTTTTTT@@@@@@@@@TTT@@TTTT@T@@@@@@@@@@@TTTTTT@@@@@@@@@
@@@@@@@TTTTT@@@@@@@@@TT@@T@T.......................TTT@TTTTTT@@@@@@@@@TTT@@TTTT@T@@@@@@@@@@@TTTTTT@@@@@@@@@
@@@@@@@TTTTT@@@@@@@@@TTTTTTTT.....................TT@TTTTTTTT@@@@@@@@TTT@@@TTTTT@@@@@@@@@@@@TT@@@@@@@@@@@@@
@@@@@@@TTTTT@@@@@@@@@TTTTTT@TTT..................TT@TTTTTTTTT@@@@@@@@TTT@@@TTTTT@@@@@@@@@@@@@@@@@@@@@@@@@@@
@@@@@@@TTTTT@@@@@@@@@@TTTTTTTTTTT...............TT@TTTTTTTTTTT@@@@@@@TT@@T@TTTTT@@@@@@@@@@@@@@@@@@@@@@@@@@@
@@@@@@TTTTTT@@@@@@@@@@T@TTTTTTT@TTT.........TTTTTTTTTTTTTTT@@@@@@@@@@TT@@T@TTTT@@@@@@@@@@@@@@@@@@@@@@@@@@@@
@@@@@@TTTTTT@@@@@@@@@@@@@@TTTTTTTTTTTTTTTTTTT@TT@TTTTTTTTTT@@@@@@@@@TT@@@@TTTT@@@@@@@@@@@@@@@@@@@@@@@@@@@@@
@@@@@@TTTTTT@@@@@@@@@@@@@@@@TTTTTTTTT@T@@TT@TTT@TTTTTTTTTT@@@@@@@@@@T@@@@@TTTT@@@@@@@@@@@@@@@@@@@@@@@@@@@@@
@@@@@@TTT@TT@@@@@@@@@@@@@@@@TTTTTTTTTTTTTTTTTTTTTTTTTTT@@@@@@@@@@@@TT@@@@@TTTT@@@@@@@@@@@@@@@@@@@@@@@@@@@@@
@@@@@@@@@@TT@@@@@@@@@@@@@@@@@@TT@TTTTTTTTTTTTTTTTTTTTTTT@@@@@@@@@@@TT@@@@@TT@@@@@@@@@@@@@@@@@@@@@@@@@@@@@@@
@@@@@@@@@TTT@@@@@@@@@@@@@@@@@@@@TTTTTTTTTTTTTTTTTTTTT@@@@@@@@@@@@@TTTT@@@@TT@T@@@@@@@@@@@@@@@@@@@@@@@@@@@@@
@@@@@@@@@TT@@@@@@@@@@@@@@@@@@@@@@@TTTTTTTTT@@TTTTTTT@@@@@@@@@@@@@@T@@TT@@@TT@@@@@@@@@@@@@@@@@@@@@@@@@@@@@@@
@@@@@@@@@TT@@@@@@@@@@@@@@@@@@@@@@TTTTTTTTTTT@T@@@@@@@@@@@@@@@@@@@TT@@TT@@@TT@@@@@@@@@@@@@@@@@@@@@@@@@@@@@@@
@@@@@@@@TTT@@@@@@@@@@@@@@@@@@@@@@@@@@@@@@@@@@@@@@@@@@@@@@@@@@@@@@T@@@@TTTTTT@@@@@@@@@@@@@@@@@@@@@@@@@@@TTT@
@@@@@@@TTTT@@@@@@@@@@@@@@@@@@@@@@@@@@@@@@@@@@@@@@@@@@@@@@@@@@@@@TT@@@@TTTTTT@@@@@@@@@@@@@@@@@@@@@@@@TTTTTT@
@@@@@@@TTTTT@@@@@@@@@@@@@@@@@@@@@TT@@@@@@@@@@@@@@@@@@@@@@@@@@@@@T@@@@@@@TTTT@@@@@@@@@@@@@@@@@@@@@@@@TTTTT@@
@@@@@@TTTTTT@@@@@@@@@@@@@@@T@@TTTT@@@@@@@@@@@@@@@@@@@@@@@@@@@@@TT@@@@TTTTTTT@@@@@@@@@@@@@@@@@@@@@@@TTTTTT@@
@@@@@@TTTTTT@@@@@@@@@@@@@@@TTTT@TT@TTT@@@@@@@@@@@@@@@@@@@@@@@@@T@@@@TTTTTTTT@@@@@@@@@@@@@@@@@@@@@@@TTTTTT@@
@@@@@@TTTTTT@@@@@@@@@@@@@@TTTTTTTTTTTTTT@@@@@@@@@@@@@@@@@@@@@@TT@@@@TTTTTTTT@@@@@@@@@@@@@@@@@@@@@@@TTTTT@@@
@@@@@@T@TTTT@@@@@@@@@@@@@TTTTTTTTTTTTTTTT@@@@@@@@@@@@@@@@@@@@@T@@@@TTTTTTTTT@@@@@@@@@@@@@@@@@@@@@@TTTTTT@@@
@@@@@@@T@TTT@@@@@@@@@@@@@TTTTTTTTTTTTTTTTTTT@@@@@@@@@@@@@@@@TTT@@@TTTTTTTTTT@@@@@@@@@@@@@@@@@@@@@@TTTTTT@@@
@@@@@@T@TTTTT@@@@@@@@@@@TTTTTTTTTTTTTTTTTTTTT@@@@@@@@@@@@@@@@T@@@TTTTTTTTTT@@@@@@@@@@@@@@@@@@@@@@TTTTTTT@@@
@@@@@@@TT@T@T@@@@@@@@@@@TTTTTTTTTTTTTTTTTTTTTTTTTT@@@@@@TTTTTTTTTTTTTTTTTT@@@@@@@@@@@@@@@@@@@@@@@TTTTTTT@@@
@@@@@@@@@T@@TT@@@@@@@@@@TTTTTTTTTTTTTTTTTTTTTTTTTTTTTTTTTTTTTTTTTTTTTTTTTT@@@@@@@@@@@@@@@@@@@@@@@TTTTTTT@@@
@@@@@@@@T@@@@T@@@@@@@@@TTTTTTTTTTTTTTTTTTTTTTTTTTTTTTTTTTTTTTTTTTTTTTTTTT@@@@@@@@@@@@@@@@@@@@@@@TTTTTTT@@@@
@@@@@@@@T@@@@T@@@@@@@@@T@TTTTTTTTTTTTTTTTTTTTTTTTTTTTTTTTTTTTTT@TTTTTTTT@@@@@@@@@@@@@@@@@@@@@@@@TTTTTTT@@@@
@@@@@@@T@@@@@TT@@@@@TT@T@TTTTTTTTTTTTTTTTTTTTTTTTTTTTTTTTTTTTTT@TTTTTTT@@@@@@@@@@@@@@@@@@@@@@@@TTTTTTTT@@@@
@@@@@@@@@@@@@@T@@@@TTTTT@TTTTTTTTTTTTTTTTTTTTTTTTTTTTTTTTTTTTT@@TTTTTT@@@@@@@@@@@@@@@@@@@@@@@@@TTTTTTTT@@@@
@@@@@@T@@T@@@@TT@@TTTTTTTTTTTTTTTTTTTTTTTTTTTTTTTTTTTTTTTTTTT@@@TTTTTT@@@@@@@@@@@@@@@@@@@@@@@@TTTTTTTTT@@@@
@@@@@@@@@@T@@@@TT@TTTTT@T@TTTTTTTTTTTTTTTTTTTTTTTTTTTTTTTTTTT@@@@TTTT@@@@@@@@@@@@@@@@@@@@@@@@TTTTTTTTTT@@@@
@@@@@@@@@@@@@@@@TT@TTT@@TTTTTTTTTTTTTTTTTTTTTTTTTTTTTTTTTTTTT@@@@TTT@@@@@@@@@@@@@@@@@@@@@@TTTTTTTTTTTTT@@@@
@@@@@@@@@@@@@@@@@TT@@@@@@TTTTTTTTTTTTTTTTTTTTTTTTTTTTTTTTTTTT@@@@TTTT@@@@@@@@@@@@@@@@@@@TTTTTTTTTTTTTTT@@@@
@@@@@@@TTTTTTTTT@@TT@@@@@@TTTTTTTTTTTTTTTTTTTTTTTTTTTTTTTTTT@@@@@TT@T@@@@@@@@@@@@@@@@@TTTTTTTTTTTTTTTTT@@@@
@@@@@@@@TTTTTTTTTTTTT@@@@@@TTTTTTTTTTTTTTTTTTTTTTTTTTTTTTTTT@@@@@TTTTT@@@@@@@@@@@@@@@@TTTTTTTTTTTTTTTTT@@@@
@@@@@@@@@TTTTTTTTTTTTT@@@@@@TTTTTTTTTTTTTTTTTTTTTTTTTTTTTTT@@@@@TT@@TT@@@@@@@@@@@@@@@@TTTTTTTTTTTTTTTTT@@@@
@@@@@@@@@@TTTTTTTTTTTTT@@@@@@@TTTTTTTTTTTTTTTTTTTTTTTTTTTTT@@@@@T@TTTTT@@@@@@@@@@@@@@@TTTTTTTTTTTTTTTTT@@@@
@@@@@@@@@@@TTTTTTTTTTTTT@@@@@@@@TTTTTTTTTTTTTTTTTTTTTTTTTT@@@@@@@@@@TTTT@@@@@@@@@@@@@@TTTTTTTTTTTTTTTTT@@@@
@@@@@@@@@@@@TTTTTTTTTT@TTT@@@@@@@@TTTTTTTTTTTTTTTTTTTTTTTT@@@@@@@@@@TTTT@@@@@@@@@@@@@@TTTTTTTTT@@@@@@@@@@@@
@@@@@@@@@@@@@TTTT@TTTTT@@TT@@@@@@@@@@@T@TTTTTTTTTTTTTTTTTT@@@@@@@@@@@@@@@T@@@@@@@TTTTTTTTT@@@@@@@@@@@@@@@@@
@@@@@@@@@@@@@@TTTTTTTTTT@@TT@@@@@@@@@@TTTTTTTTTTTTTTTTTTTT@@@@@@@@@@@@@@@TTT@@@@TTTTTTTTT@@@@@@@@@@@@@@@@@@
@@@@@@@@@@@@@@TTTTTTTTTTT@@TT@@@@@@@@@@T@TTTTTTTTT@@@@@@TTT@@@@@@@@@@@@@@@TTT@@@TTTTTTT@@@@@@@@@@@@@@@@@@@@
@@@@@@@@@@@@@@@TTTTTTTTTTT@@TT@@@@@@@@@TTTTTTTTTT@@@@@@@TTTT@@@@@@@@@@@@@@TTT@@TTTTTT@@@@@@@@@@@@@@@@@@@@@@
@@@@@@@@@@@@@@@TTTTTTTTTTTT@@TTTTTTTTT@T@@TTTTT@@@@@@@@@@TTTTT@@@@@@@@@@@@@TT@@TTTTT@@@@@@T@@@@@@@@@@@@@@@@
@@@@@@@@@@@@@@@@TTTTTTTTTTTTTTTTTTTTTTTTTTTTTTTTT@@@@@@@TTTTTTTT@TT@@@@@@@@TT@TTTTTT@@@@@@@@T@@@@@@@@@@@@@@
@@@@@@@@@@@@@@@@@TTTTTTTTTTTTTTTTTTTTTTTTTT@@TTTTTTTTTTTT@TTTTTTTTTTTTTT@@@@T@TTTTT@@@@@@@T@@@T@@@@@@@@@@@@
@@@@@@@@@@@@@@@@@TTTTTTTTTTTTTTTTTTTTTTT@@@@@TTTTTTTTTTT@@@TTTTTTTTTTTTTTTTT@TTTTT@@@@@@@@@@TT@@@@@@@@@@@@@
@@@@@@@@@@@@@@@@@@TTTTTTTTTTTTTTTTTTTT@@@@@@TTTTTTTTTTTTTTTTTTTTTTTTTTTTTTTTTTTT@@@@@@@@@@TT@@@@@@@@@@@@@@@
@@@@@@@@@@@@@@@@@@@@@TTTTTTTTTTTTTT@@@@@@@@@@TTTTTTTTTTTTTTTTTTTTTTTTTTTTTTTTTTT@T@@@@@@@@@@@@@@@@@@@@@@@@@
@@@@@@@@@@@@@@@@@@@@@@@@@@@@@@@@@TTTTTTTTTTTTTTTTTTTTTTTTTTTTTTTTTTTTTTTTTTTTTT@@TT@@@@@@@@@@@@@@@@@@@@@@@@
@@@@@@@@@@@@@@@@@@@@@@@@@@@@@@@@TTTTTTTTTTTTTTTTTTTTTTTTTTTTTTTTTTTTTTTTTTTTTT@@@TTTT@@@@@@@@@@@@@@@@@@@@@@
@@@@@@@@@@@@@@@@@@@@@@@@@@@@@@TTTTTTTTTTTTTTTTTTTTTTTTTTTTTTTTTTTTTTTTTTTTTTT@@@@TT@T@@@@@@@@@@@@@@@@@@@@@@
@@@@@@@@@@@@@@@@@@@@@@@@@@@@@TTTTTTTTTTTTTTTTTTTTTTTTTTTTTTTTTTTTTTTTTTTTTTT@@@@@@TTTT@@@@@@@@@@@@@@@@@@@@@
@@@@@@@@@@@@@@@@@@@@@@@@@@@TTTTTTTTTTTTTTTTTTTTTTTTTTTTTTTTTTTTTTTTTTTTTTTT@@@@@@@@TTT@T@@@@@@@@@@@@@@@@@@@
@@@@@@@@@@@@@@@@@@@@@@@@@@@@@@@@@@@@@@@@@@@@@@@@@@@@@@@@@@@@@@@@@@@@@@@@@@@@@@@@@@@@TTTTT@@@@@@@@@@@@@@@@@@
