type octile
height 47
width 46
map
TTTTTTTTTTTTTTTTTTTTTT@@@@@@@@@@@@@@@@@@@@@@@@
TTTTTTTTTTTTTTTTTTTTTT@@@@@@@@@@@@@@@@@@@@@@@@
TTTTTTTTTTTTTTTTTTTTTT@@@@@@@@@@@@@@@@@@@@@@@@
TTTTTTTTT....TTTTTTTTT@@@@@@@@@@@@@@@@@@@@@@@@
TTTTTTTTT....TT.TTTTTT@@@@@@@@@@@@@@@@@@@@@@@@
TTTTTTTT.........TTTTT@@@@@@@@@@@@@@@@@@@@@@@@
TTTTTTTT.........TTTTT@@@@@@@@@@@@@@@@@@@@@@@@
TTTTTTT..........TTTTT@@@@@@@@@@@@@@@@@@@@@@@@
TTTTTTT.........TTTTTT@@@@@@@@@@@@@@@@@@@@@@@@
TTTTTTT.........TTTTTT@@@@@@@@@@@@@@@@@@@@@@@@
TTTTTTTTTTTTT...TTTTTT@@@@@@@@@@@@@@@@@@@@@@@@
TTTTTTTTTTTTT....TTTTTT@@@@@@@@@@@@@@@@@@@@@@@
TTTTTTTTTTTTT....TTTTTTTTTTTTTTTTTTTTTTTTTTTTT
TTTTTTTTTTTTT....TTTTTTTTTTTTTTTTTTTTTTTTTTTTT
TTTTTTTTTTTTT....TTTTTTTTTTTTTTTTTTTTTTTTTTTTT
TTTTTT............TTTTTTT........TTTTTTTTTTTTT
TTTT...............TTTTTT........TTTTT..TTTTTT
TTTTT....................................TTTTT
TTTTT.....................................TTTT
TTTTTT...................................TTTTT
TTTTTT...................................TTTTT
TTTTTT...................TTTTTTTTT.......TTTTT
TTTTTT...................TTTTTTTTT.......TTTTT
TTTTT....................TTTTTTTTT.......TTTTT
TTTTT....................TTTTTTTTT.......TTTTT
TTTTT....................TTTTTTTTT.......TTTTT
TTT......................................TTTTT
TTT......................................TTTTT
TTT......................................TTTTT
TTT...................TTTTTTTTTTTTTTTTT.TTTTTT
TTTT...............TTTTTTTTTTTTTTTTTTTTTTTTTTT
TTTTT............TTTTTTTTTTTTTTTTTTTTTTTTTTTTT
TTTTTT..........TTTTTTTTTTTTTTTTTTTTTTTTTTTTTT
TTTTTT..........TTTTTTTTTTTTTTTTTTTTTTTTTTTTTT
TTTTTT..........TTTTTTT@@@@@@@@@@@@@@@@@@@@@@@
@@TT..............TT@@@@@@@@@@@@@@@@@@@@@@@@@@
@@TT..............TT@@@@@@@@@@@@@@@@@@@@@@@@@@
@@TT..............TT@@@@@@@@@@@@@@@@@@@@@@@@@@
@@TT..............TT@@@@@@@@@@@@@@@@@@@@@@@@@@
@@TT..............TT@@@@@@@@@@@@@@@@@@@@@@@@@@
@@TT..............TT@@@@@@@@@@@@@@@@@@@@@@@@@@
@@TT..............TT@@@@@@@@@@@@@@@@@@@@@@@@@@
@@TT..............TT@@@@@@@@@@@@@@@@@@@@@@@@@@
@@TT..............TT@@@@@@@@@@@@@@@@@@@@@@@@@@
@@TT..............TT@@@@@@@@@@@@@@@@@@@@@@@@@@
@@TT..TTT....TTT..TT@@@@@@@@@@@@@@@@@@@@@@@@@@
@@TTTTTTT....TTTTTTT@@@@@@@@@@@@@@@@@@@@@@@@@@
