type octile
height 155
width 75
map
@@@@@@@@@@@@@@@@@@@@@@@@@@@@TTTTTT.......TTTTTT@@@@@@@@@@@@@@@@@@@@@@@@@@@@
@@@@@@@@@@@@@@@@@@@@@@@@@@@@TTTTTT.......TTT.TT@@@@@@@@@@@@@@@@@@@@@@@@@@@@
@@@@@@@@@@@@@@@@@@@@@@@@@@@@TT...............TT@@@@@@@@@@@@@@@@@@@@@@@@@@@@
@@@@@@@@@@@@@@@@@@@@@@@@@@@@TT...............TT@@@@@@@@@@@@@@@@@@@@@@@@@@@@
@@@@@@@@@@@@@@@@@@@@@@@@@@@@TT...............TT@@@@@@@@@@@@@@@@@@@@@@@@@@@@
@@@@@@@@@@@@@@@@@@@@@@@@@@@@TT...............TT@@@@@@@@@@@@@@@@@@@@@@@@@@@@
@@@@@@@@@@@@@@@@@@@@@@@@@@@@TT...............TT@@@@@@@@@@@@@@@@@@@@@@@@@@@@
@@@@@@@@@@@@@@@@@@@@@@@@@@@@TT...............TT@@@@@@@@@@@@@@@@@@@@@@@@@@@@
@@@@@@@@@@@@@@@@@@@@@@@@@@@@TT...............TT@@@@@@@@@@@@@@@@@@@@@@@@@@@@
@@@@@@@@@@@@@@@@@@@@@@@@@@@@TT...............TT@@@@@@@@@@@@@@@@@@@@@@@@@@@@
@@@@@@@@@@@@@@@@@@@@@@@@@@@@TT...............TT@@@@@@@@@@@@@@@@@@@@@@@@@@@@
@@@@@@@@@@@@@@@@@@@@@@@@@@@@TT...............TT@@@@@@@@@@@@@@@@@@@@@@@@@@@@
@@@@@@@@@@@@@@@@@@@@@@@@@TTTTT...............TTTT@@@@@@@@@@@@@@@@@@@@@@@@@@
@@@@@@@@@@@@@@@@@@@@@@@@@TTTTT...............TTTT@@@@@@@@@@@@@@@@@@@@@@@@@@
@@@@@@@@@@@@@@@@@@@@@@@@@TTTTT...............TTTT@@@@@@@@@@@@@@@@@@@@@@@@@@
@@@@@@@@@@@@@@TTTTTTTTTTTTTTTT...............TTTTTTTTTTTTTTTT@@@@@@@@@@@@@@
@@@@@@@@@@@@@@TTTTTTTTTTTTTTTT...............TTTTTTTTTTTTTTTT@@@@@@@@@@@@@@
@@@@@@@@@@@@@@@TTTTTTTTTTTTTT................TTTTTTTTTTTTTTT@@@@@@@@@@@@@@@
@@@@@@@@@@@@@@TTTTTTTTTTT......................TTTTTTTTTTTTTT@@@@@@@@@@@@@@
@@@@@@@@@@@@@@TTTTTTT..........................TTTTT....TTTTT@@@@@@@@@@@@@@
@@@@@@@@@@@@@@TTTTTTT....................................TTTT@@@@@@@@@@@@@@
@@@@@@@@@@@@@@TTTTTT...TTTTT...................TTTTT......TTT@@@@@@@@@@@@@@
@@@@@@@@@@@@@@TTTTT....TTTTT...................TTTTT....TTTTT@@@@@@@@@@@@@@
@@@@@@@@@@@@@@TTTTT....TTTTT...................TTTTT....TTTTT@@@@@@@@@@@@@@
@@@@@@@@@@@@@@TTTTT....TTTTT...................TTTTT....TTTTT@@@@@@@@@@@@@@
@@@@@@@@@@@@@@TTTTT....TTTTT...................TTTTT....TTTTT@@@@@@@@@@@@@@
@@@@@@@@@@@@@@TTTTT....TTTTT...................TTTTT....TTTTT@@@@@@@@@@@@@@
@@@@@@@@@@@@@@TTTTTT......................................TTT@@@@@@@@@@@@@@
@@@@@@@@@@@@@@TTTTTTT....................................TTTT@@@@@@@@@@@@@@
@@@@@@@@@@@@@@TTTTTTT..........................TTTTT....TTTTT@@@@@@@@@@@@@@
@@@@@@@@@@@@@@TTTTTTTTTTT......................TTTTTTTTTTTTT@@@@@@@@@@@@@@@
@@@@@@@@@@@@@@@TTTTTTTTTTTTTT................TTTTTTTTTTTTTT@@@@@@@@@@@@@@@@
@@@@@@@@@@@@@@TTTTTTTTTTTTTTTT...............TTTTTTTTTTTTTTTT@@@@@@@@@@@@@@
@@@@@@@@@@@@@@TTTTTTTTTTTTTTTT...............TTTTTTTTTTTTTTTT@@@@@@@@@@@@@@
@@@@@@@@@@@@@@@@@@@@@@@@@TTTTT...............TTTT@@@@@@@@@@@@@@@@@@@@@@@@@@
@@@@@@@@@@@@@@@@@@@@@@@@@TTTTT...............TTTT@@@@@@@@@@@@@@@@@@@@@@@@@@
@@@@@@@@@@@@@@@@@@@@@@@@@TTTTTTT...........TTTTTT@@@@@@@@@@@@@@@@@@@@@@@@@@
@@@@@@@@@@@@@@@@@@@@@@@@@TTTTTTT..........TTTTTTT@@@@@@@@@@@@@@@@@@@@@@@@@@
@@@TTTTTTTTTTTTTTTTTTTTTTTTTTTTT..........TTTTTTTTTTTTTTTTTTTTTTTTTTTTTT@@@
@@@TTTTTTTTTTTTTTTTTTTTTTTTTTTTT...........TTTTTTTTTTTTTTTTTTTTTTTTTTTTT@@@
@@@TTTTTTTTTTTTTTTTTTTTTTTTTTTTT...........TTTTTTTTTTTTTTTTTTTTTTTTTTTTT@@@
@@@TTTTTTTTTTTTTTTTTTTTTTTT.....................TTTTTTTTTTTTTTTTTTTTTTTT@@@
@@@TTTTT....TTT.........................................TTT.......TTTTTT@@@
@@@TTTT............................................................TTTTT@@@
@@@TTT..............................................................TTTT@@@
@@@TTTT.............................................................TTTT@@@
@@@TTTT.............................................................TTTT@@@
@@@TTTTT............................................................TTTT@@@
@@@TTTTT............................................................TTTT@@@
@@@TTTTT............................................................TTTT@@@
@@@TTTTT.............................................................TTT@@@
@@TTTTTT.............................................................TTT@@@
@TTTTTTT..TTT...................................TT...................TTTTT@
T@TTTTTTTTTTTTTTTTTTTTTTTTTTT..................TTTTTTT....TTTTTT....TTTTT@@
T@TTTTTTTTTTTTTTTTTTTTTTTTTTTT.................TTTTTTTTTTTTTTTTTTTTTTTTTT@T
T@TTTTTTTTTTTTTTTTTTTTTTTTTTTT.................TTTTTTTTTTTTTTTTTTTTTTTTTT@T
T@TTTTTTTTTTTTTTTTTTTTTTTTTTT..................TTTTTTTTTTTTTTTTTTTTTTTTTT@T
@@TTTTTTTT............TTTTTTT...................TTTTTT..............TTTTT@@
@TTTTTT.............................................................TTTTT@@
@@@TTTT.............................................................TTTT@@@
@@@TTTT.............................................................TTTT@@@
@@@TTTT.............................................................TTTT@@@
@@@TTTT.............................................................TTTT@@@
@@@TTTT.............................................................TTTT@@@
@@@TTTT.............................................................TTTT@@@
@@TTT................................................................TTT@@@
@TTTT....TT..........................................................TTTTT@
T@TTTTTTTTTTTTTTTTTTTTTTTT......................TTTTTTTTT......TTTTTTTTTT@@
T@TTTTTTTTTTTTTTTTTTTTTTTTTT..................TTTTTTTTTTTTT...TTTTTTTTTTT@T
T@TTTTTTTTTTTTTTTTTTTTTTTTTT..................TTTTTTTTTTTTT....TTTTTTTTTT@T
T@TTTTTTTTTTTTTTTTTTTTTTTTTTT.................TTTTTTTTTTTTT....TTTTTTTTTT@T
@@TTTT................TTTT......................TTTTTTTTT......TTTTTTTTTT@@
@TTTTT...............................................................TTTT@@
@@@TTT...............................................................TTT@@@
@@@TTT...............................................................TTT@@@
@@@TTTT.............................................................TTTT@@@
@@@TTTT...........................................................TTTTTT@@@
@@@TTTTT..........................................................TTTTTT@@@
@@@TTTTT..........................................................TTTTTT@@@
@@@TTTTT..................................TTTT....................TTTTTT@@@
@@@TTTTTT..TTTTT...........TTTTTTTTT...TTTTTTTTT..................TTTTTT@@@
@@@TTTTTT..TTTTT.....TTTTTTTTTTTTTTT...TTTTTTTTTTTTTTTTTT........TTTTTTT@@@
@@@TTTT...TTTTTT.....TTTTTTTTTTTTTTT...TTTTTTTTTTTTTTTTTT........TTTTTTT@@@
@@@TTTT....TTTTT.....TTTTTTTTTTTTTTT...TTTTTTTTTTTTTTTTTT........TTTTTTT@@@
@@@TTTT....TTTTT.....TTT@@@TTTTTTTTT...TTTTTTTTT@@@TTT..............TTTT@@@
@@@TTTT....TTTTT.....TTT@@@TTTTT...........TTTTT@@@TTT...............TTT@@@
@@@TTT...............TTT@@@TTTTT...........TTTTT@@@TT................TTT@@@
@@@TTTT.............TTTT@@@TTTTT...........TTTTT@@@TT................TTT@@@
@@@TTTTTTTT.....TT.TTTTT@@@TTTTT...........TTTTT@@@TTT..............TTTT@@@
@@@TTTTTTTTT...TTTTTTTTT@@@TTTTT...........TTTTT@@@TTTTT...........TTTTT@@@
@@@TTTTTTTTT..TTTTTTTTTT@@@TTTTT...........TTTTT@@@TTTTTT.........TTTTTT@@@
@@@TTTTTTTTTTTTTTTTTTTTT@@TTTTTT...........TTTTTT@@TTTTTTTTTTTTTTTTTTTTT@@@
@@@TTTTTTTTTTTTTTTTTTTTT@@TTT................TTTT@@TTTTTTTTTTTTTTTTTTTTT@@@
@@@TTTTTTTTTTTTTTTTTTTTT@TTTT................TTTT@@TTTTTTTTTTTTTTTTTTTTT@@@
@@@TTTTTTTTTTTTTTTTTTTTTTTTTT................TTTTTTTTTTTTTTTTTTTTTTTTTTT@@@
@@@@@@@@@@@@@@@@@@@@@@TTTTTTT................TTTTTTTT@@@@@@@@@@@@@@@@@@@@@@
@@@@@@@@@@@@@@@@@@@@@TTTTTTTT................TTTTTTTT@@@@@@@@@@@@@@@@@@@@@@
@@@@@@@@@@@@@@@@@@@@@TTTTTTTTTTTTTT.....TTTT.TTTTTTTTT@@@@@@@@@@@@@@@@@@@@@
@@@TTTTTTTTTTTTTTTTTTTTTTTTTTTTTTTT.....TTTT.TTTTTTTTTTTTTTTTTTTTTTTTTTT@@@
@@@TTTTTTTTTTTTTTTTTTTTTTTTTTTTTT.......TTTTTTTTTTTTTTTTTTTTTTTTTTTTTTTT@@@
@@@TTTTTTTTTTTTTTTTTTTTTTTT..TTTT.......TTTT...TTTTTTTTTTTTTTTTTTTTTTTTT@@@
@@@TTTTTTTTTTTTTTTTTTTTT..........................TTTTTTTTTTTTTTTTTTTTTT@@@
@@@TTTTT..........................................................TTTTTT@@@
@@@TTTT............................................................TTTTT@@@
@@@TTT..............................................................TTTT@@@
@@@TT................................................................TTT@@@
@@@TT....TTT.........................................................TTT@@@
@@@TT..TTTTTTTTT........TT...........................................TTT@@@
@@@TTT.TTTTTTTTTTTTTTTTTTT..........................................TTTT@@@
@@@TTT.TTTTTTTTTTTTTTTTTTTT.........................................TTTT@@@
@@@TTTTTTTTTTTTTTTTTTTTTTTT.................TTTT....................TTTT@@@
@@@TTT.TTTTTTTTTTTTTTTTTTTT...............TTTTTTT.TTT...........TTTTTTTT@@@
@@@TTT....................................TTTTTTTTTTTTTTTTTTTTTTTTTTTTTT@@@
@@@TT.....................................TTTTTTTTTTTTTTTTTTTTTTTTTTTTTT@@@
@@@TT.......................................TTTTTTTTTTTTTTTTTTTTTTTTTTTT@@@
@@@TT..........................................TTTTTTTTTTTTTTTTTTTTT.TTT@@@
@@@TT................................................................TTT@@@
@@@TT................................................................TTT@@@
@@@TT................................................................TTT@@@
@@@TT...........TTT..................................................TTT@@@
@@@TTTTTTTTTTTTTTTTTTTTTT............................................TTT@@@
@@@TTTTTTTTTTTTTTTTTTTTTTTT........TT................................TTT@@@
@@@TTTTTTTTTTTTTTTTTTTTTTTT......TTTTTT..............................TTT@@@
@@@TTTTTTTTTTTTTTTTTTTTTTT.......TTTTTT..............................TTT@@@
@@@TTTTTTTTTTTTTTTTTTTTTT......TTTTTTTTT.......TTTTTTTTT.TTTTTTTTT...TTT@@@
@@@TT..........................TTTTTTTTT.......TTTTTTTTTTTTTTTTTTT..TTTT@@@
@@@TT..........................TTTTTTTTT.......TTTTTTTTTTTTTTTTTTT..TTTT@@@
@@@TT............................TTTTTT........TTTTTTTTTTTTTTTTTTT..TTTT@@@
@@@TTT...........................T.TT.T..................TTTTTTTTT..TTTT@@@
@@@TTT.............................TT...............................TTTT@@@
@@@TTT...............................................................TTT@@@
@@@TTT...............................................................TTT@@@
@@@TTT...............................................................TTT@@@
@@@TT................................................................TTT@@@
@@@TT................................................................TTT@@@
@@@TT....................TTT.........................................TTT@@@
@@@TT....................TTT............TTT..TT............TTTT.....TTTT@@@
@@TTTTTT................TTTTT..........TTTTTTTTTTTTTTTTTTTTTTTTT...TTTTT@@@
@@TTTTTTTTTTTTTTTTTTTTTTTTTTT........TTTTTTTTTTTTTTTTTTTTTTTTTTT..TTTTTT@@@
@@TTTTTTTTTTTTTTTTTTTTTTTTTTT........TTTTTTTTTTTTTTTTTTTTTTTTTTT.TTTTTTT@@@
@@TTTTTTTTTTTTTTTTTTTTTTTTTTT..........TTTTT...............TTTT@TTTTTTTT@@@
@@TTTTTT................TTTT............TTT..TTTTTTTTTTTTTTTTTTTTTTTTTTT@@@
@@@TT........................................TTTTTTTTTTTTTTTTTTTTTTTTTTT@@@
@@@TT........................................TTTT@@@@@@@@@@@@@@@@@@@@@@@@@@
@@@TT........................................TTT@@@@@@@@@@@@@@@@@@@@@@@@@@@
@@@TT........................................TTT@@@@@@@@@@@@@@@@@@@@@@@@@@@
@@@TT........................................TTT@@@@@@@@@@@@@@@@@@@@@@@@@@@
@@@TT........................................TTT@@@@@@@@@@@@@@@@@@@@@@@@@@@
@@@TTT......................................TTTT@@@@@@@@@@@@@@@@@@@@@@@@@@@
@@@TTTT....................................TTTTT@@@@@@@@@@@@@@@@@@@@@@@@@@@
@@@TTTTTTTTTTTTTTTTTTTTTTTTTTTTTTTTTTTTTTTTTTTTT@@@@@@@@@@@@@@@@@@@@@@@@@@@
@@@TTTTTTTTTTTTTTTTTTTTTTTTTTTTTTTTTTTTTTTTTTTTT@@@@@@@@@@@@@@@@@@@@@@@@@@@
@@@TTTTTTTTTTTTTTTTTTTTTTTTTTTTTTTTTTTTTTTTTTTTT@@@@@@@@@@@@@@@@@@@@@@@@@@@
@@@TTTTTTTTTTTTTTTTTTTTTTTTTTTTTTTTTTTTTTTTTTTTT@@@@@@@@@@@@@@@@@@@@@@@@@@@
@@@TTTTTTTTTTTTTTTTTTTTTTTTTTTTTTTTTTTTTTTTTTTTT@@@@@@@@@@@@@@@@@@@@@@@@@@@
