type octile
height 70
width 68
map
@@@@@@@@@@@@@@@@@@@@@@@@@@@@@@@@@@@@@@@@@@@@@@@@@@@@@@@@@@@@@@@@@@@@
@@@@@@@@@@@@@@@@@@@@@@@@@@@@@@@@@@@@@@@@@@@@@@@@@@@@@@@@@@@@@@@@@@@@
@@@@@@@@@@@@@@@@@@@@@@@@@@@@@@@@@@@@@@@@@@@@@@@@@@@@@@@@@@@@@@@@@@@@
@@@@@@@@@@@@@@@@@@@@@@@@@@@@@@@@@@@@@@@@@@@@@@@@@@@@@@@@@@@@@@@@@@@@
@@@@@@@@@@@@@@@@@@@@@@@@@@@@@@@@@@@@@@@@@@@@@@@@@@@@@@@@@@@@@@@@@@@@
@@@@@@@@@@@@@@@@@@@@@@@@@@@@@@@@@@@@@@@@@@@@@@@@@@@@@@@@@@@@@@@@@@@@
@@@@@@@@@@@@@@@@@@@@@@@@@@@@@@@@@@@@@@@@@@@@@@@@@@@@@@@@@@@@@@@@@@@@
@@@@@@@@@@@@@@@@@@@@@@@@@@@@@@@@@@@@@@@@@@@@@@@@@@@@@@@@@@@@@@@@@@@@
@@@@@@@@@@@@@@@@@@@@@@@@@@@@@@@@@@@@@@@@@@@@@@@@@@@@@@@@@@@@@@@@@@@@
@@@@@@@@@@@@@@@@@@@@@@@@@@@@@@@@@@@@@@@@@@@@@@@@@@@@@@@@@@@@@@@@@@@@
@@@@@@@@@@@@@@@@@@@@@@@@@@@@@@@@.@@@@@@@@@@@@@@@@@@@@@@@@@@@@@@@@@@@
@@@@@@@@@@@@@@@@@@@@@@@@@@@@@@@...@@@@@@@@@@@@@@@@@@@@@@@@@@@@@@@@@@
@@@@@@@@@@@@@@@@@@@@@@@@@@@@@@.....@@@@@@@@@@@@@@@@@@@@@@@@@@@@@@@@@
@@@@@@@@@@@@@@@@@@@@@@@@@@@@@.......@@@@@@@@@@@@@@@@@@@@@@@@@@@@@@@@
@@@@@@@@@@@@@@@@@@@@@@@@@@@@@........@@@@@@@@@@@@@@@@@@@@@@@@@@@@@@@
@@@@@@@@@@@@@@@@@@@@@@@@@@@@@...........@@@@@@@@@@@@@@@@@@@@@@@@@@@@
@@@@@@@@@@@@@@@@@@@@@@@@@@@@.............@@@@@@@@@@@@@@@@@@@@@@@@@@@
@@@@@@@@@@@@@@@@@@@@@@@@@.@...............@@@@@@@@@@@@@@@@@@@@@@@@@@
@@@@@@@@@@@@@@@@@@@@@@@@.......@@@.........@@@@@@@@@@@@@@@@@@@@@@@@@
@@@@@@@@@@@@@@@@@@@@@@@.......@@@@...@@.....@@@@@@@@@@@@@@@@@@@@@@@@
@@@@@@@@@@@@@@@@@@@@@@.......@@@@@@@..@@.....@@@@@@@@@@@@@@@@@@@@@@@
@@@@@@@@@@@@@@@@@@@@@........@@@@@@@@..@@.....@@@@@@@@@@@@@@@@@@@@@@
@@@@@@@@@@@@@@@@@@@@...........@@@@@@@..@......@@@@@@@@@@@@@@@@@@@@@
@@@@@@@@@@@@@@@@@@@@@..........@@@@@@@@.........@@@@@@@@@@@@@@@@@@@@
@@@@@@@@@@@@@@@@@.@@@@..........@@@@@@@..........@@@@@@@@@@@@@@@@@@@
@@@@@@@@@@@@@@@@...@@@@......@@..@@@@@............@@@@@@@@@@@@@@@@@@
@@@@@@@@@@@@@@@@@...@@@@......@@..@@@.............@@@@@@@@@@@@@@@@@@
@@@@@@@@@@@@@@@@@@...@@@@......@@..@.............@@@@@@@@@@@@@@@@@@@
@@@@@@@@@@@@@@@@@@@..@@@@@......@@..............@@@@@@@@@@@@@@@@@@@@
@@@@@@@@@@@@@@@@@@@@.@@@@@@....................@@@@@@@@@@@@@@@@@@@@@
@@@@@@@@@@@@@.@@@@@...@@@@@@..................@@@@@@@@@@@@@@@@@@@@@@
@@@@@@@@@@@@...@@@.....@@@@@@................@@@@@@@@@@.@@@@@@@@@@@@
@@@@@@@@@@@.....@.........@@@@..............@@@@@@@@@@...@@@@@@@@@@@
@@@@@@@@@@@@................@@@@...........@@@@@@@@......@@@@@@@@@@@
@@@@@@@@@@@@@................@@@@.........@@@@@@@@@.......@@@@@@@@@@
@@@@@@@@@@@@@@...............@@@@........@@@@@@@@.....@@..@@@@@@@@@@
@@@@@...@@@@@................@@@@.......@@@@@@.......@@@@..@@@@@@@@@
@@@@@@...@@@.............................@@@@.......@@@@@....@@@@@@@
@@@@@@@...@...............@........................@@@@@@.....@@@@@@
@@@@@@@@.................@@@.......................@@@@@.....@@@@@@@
@@@@@@@@@...............@@@........................@@@@.....@@@@@@@@
@@@@@@@@@@.............@@@.....................@...@@@@...@@@@@@@@@@
@@@@@@@@@@@...........@@@.....................@@@....@@..@@@@@@@@@@@
@@@@@@@@@@@@.........@@@......................@@@@......@@@@@@@@@@@@
@@@@@@@@@@@@@.......@@@@.......................@@@@....@@@@@@@@@@@@@
@@@@@@@@@@@@@......@@@@@.........................@@@..@@@@@@@@@@@@@@
@@@@@@@@@@@@@@....@@@@@.........@@................@@@@@@@@@@@@@@@@@@
@@@@@@@@@@@@@@@..@@@...........@@@@@...............@@@@@@@@@@@@@@@@@
@@@@@@@@@@@@@@@@@@@..........@@@@@@@...............@@@@@@@@@@@@@@@@@
@@@@@@@@@@@@@@@@@@...........@@@@@@@..............@@@@@@@@@@@@@@@@@@
@@@@@@@@@@@@@@@@@@............@@@@@@.@@@.........@@@@@@@@@@@@@@@@@@@
@@@@@@@@@@@@@@@@@@@..........@@@@@@@@@@@........@@@@@@@@@@@@@@@@@@@@
@@@@@@@@@@@@@@@@@@@@........@@@@@@@@@@@@.......@@@@@@@@@@@@@@@@@@@@@
@@@@@@@@@@@@@@@@@@@@@.......@@@@@@@@@@@.......@@@@@@@@@@@@@@@@@@@@@@
@@@@@@@@@@@@@@@@@@@@@@.......@@@@@@@@@.......@@@@@@@@@@@@@@@@@@@@@@@
@@@@@@@@@@@@@@@@@@@@@@@.......@@@@@@@.......@@@@@@@@@@@@@@@@@@@@@@@@
@@@@@@@@@@@@@@@@@@@@@@@@.......@@@@@.......@@@@@@@@@@@@@@@@@@@@@@@@@
@@@@@@@@@@@@@@@@@@@@@@@@@.................@@@@@@@@@@@@@@@@@@@@@@@@@@
@@@@@@@@@@@@@@@@@@@@@@@@@@...............@@@@@@@@@@@@@@@@@@@@@@@@@@@
@@@@@@@@@@@@@@@@@@@@@@@@@@@.............@@@@@@@@@@@@@@@@@@@@@@@@@@@@
@@@@@@@@@@@@@@@@@@@@@@@@@@@@...........@@@@@@@@@@@@@@@@@@@@@@@@@@@@@
@@@@@@@@@@@@@@@@@@@@@@@@@@@@@.........@@@@@@@@@@@@@@@@@@@@@@@@@@@@@@
@@@@@@@@@@@@@@@@@@@@@@@@@@@@@@.......@@@@@@@@@@@@@@@@@@@@@@@@@@@@@@@
@@@@@@@@@@@@@@@@@@@@@@@@@@@@@@@@....@@@@@@@@@@@@@@@@@@@@@@@@@@@@@@@@
@@@@@@@@@@@@@@@@@@@@@@@@@@@@@@@@@@@@@@@@@@@@@@@@@@@@@@@@@@@@@@@@@@@@
@@@@@@@@@@@@@@@@@@@@@@@@@@@@@@@@@@@@@@@@@@@@@@@@@@@@@@@@@@@@@@@@@@@@
@@@@@@@@@@@@@@@@@@@@@@@@@@@@@@@@@@@@@@@@@@@@@@@@@@@@@@@@@@@@@@@@@@@@
@@@@@@@@@@@@@@@@@@@@@@@@@@@@@@@@@@@@@@@@@@@@@@@@@@@@@@@@@@@@@@@@@@@@
@@@@@@@@@@@@@@@@@@@@@@@@@@@@@@@@@@@@@@@@@@@@@@@@@@@@@@@@@@@@@@@@@@@@
@@@@@@@@@@@@@@@@@@@@@@@@@@@@@@@@@@@@@@@@@@@@@@@@@@@@@@@@@@@@@@@@@@@@
