type octile
height 70
width 56
map
@@@@@@@@@@@@@@@@@@@@@@@@@@@@@@@@@@@@@@@@@@@@@@@@@@@@@@@@
@@@@@@@@@@@@@@@@@@@@@@@@@@@@@@@@@@@@@@@@@@@@@@@@@@@@@@@@
@@@@@@@@@@@@@@@@@@@@@@@@@@@@@@@@@@@@@@@@@@@@@@@@@@@@@@@@
@@@@@@@@@@@@@@@@@@@@@@@@@@@@@@@@@@@@@@@@@@@@@@@@@@@@@@@@
@@@@@@@@@@@@@@@@@@@@@@@@@@@@@@@@@@@@@@@@@@@@@@@@@@@@@@@@
@@@@@@@@@@@@@@@@@@@@@@@@@@@@@@@@@@@@@@@@@@@@@@@@@@@@@@@@
@@@@@@@@@@@@@@@@@@@@@@@@@@@@@@@@@@@@@@@@@@@@@@@@@@@@@@@@
@@@@@@@@@@@@@@@@@@@@@@@@@@@@@@@@@@@@@@@@@@@@@@@@@@@@@@@@
@@@@@@@@@@@@@@@@@@@@@@@@@@@@@@@@@@@@@@@@@@@@@@@@@@@@@@@@
@@@@@@@@@@@@@@@@@@@@@@@@@@@@@@@@@@@@@@@@@@@@@@@@@@@@@@@@
@@@@@@@@@@@@@@@@@@@@@@@@@@@@@@@@@@@@@.@@@@@@@@@@@@@@@@@@
@@@@@@@@@@@@@@@@@@@@@@@@@@@@@@@@@@@@@..@@@@@@@@@@@@@@@@@
@@@@@@@@@@@@@@@@@@@@@@@@@@@@@@@@@@@@@...@@@@@@@@@@@@@@@@
@@@@@@@@@@@@@@@@@@@@@@@@@@@@@@@@@@@......@@@@@@@@@@@@@@@
@@@@@@@@@@@@@@@@@@@@@@@@@@@@@@@@@@@.......@@@@@@@@@@@@@@
@@@@@@@@@@@@@@@@@@@@@@@@@@@@@@@@@.........@@@@@@@@@@@@@@
@@@@@@@@@@@@@@@@@@@@@@@@@@@@@@@@@........@@@@@@@@@@@@@@@
@@@@@@@@@@@@@@@@@@@@@@@@@@@@@@@@@......@@@@@@@@@@@@@@@@@
@@@@@@@@@@@@@@@@@@@@@@@@@@@@@@........@@@@@@@@@@@@@@@@@@
@@@@@@@@@@@@@@@@@@@@@@@@@@.@@@......@@@@@@@@@@@@@@@@@@@@
@@@@@@@@@@@@@@@@@@@@@@@.....@@@....@@@@@@@@@@@@@@@@@@@@@
@@@@@@@@@@@@@@@@@@@@@@...........@@@@@@@@@@@@@@@@@@@@@@@
@@@@@@@@@@@@@@@@@@@@@@@..........@@@@@@@@@@@@@@@@@@@@@@@
@@@@@@@@@@@@@@@@@@@@@@@@.........@@@@@@@@@@@@@@@@@@@@@@@
@@@@@@@@@@@@@@@@@@@@@@@@@........@@@@@@@@@@@@@@@@@@@@@@@
@@@@@@@@@@@@@@@@@@.@@@@@@@.....@@@@@@@@@@@@@@@@@@@@@@@@@
@@@@@@@@@@@@@@@@....@@@@@@@...@@@@@@@@@@@@@@@@@@@@@@@@@@
@@@@@@@@@@@@@@@@.....@@@@@....@@@@@@@@@@@@@@@@@@@@@@@@@@
@@@@@@@@@@@@@@@@......@@@.....@@@@@@.@@@@@@@@@@@@@@@@@@@
@@@@@@@@@@@@@@@................@@@@...@@@@@@@@@@@@@@@@@@
@@@@@@@@@@@@@@@@..............@@@@.....@@@@@@@@@@@@@@@@@
@@@@@@@@@@@@@@@@@............@@@@.......@@@@@@@@@@@@@@@@
@@@@@@@@@@@@@@@@@@.............@@.......@@@@@@@@@@@@@@@@
@@@@@@@@@@@@@@@@@..............@@.......@@@@@@@@@@@@@@@@
@@@@@@@@@@@@@@@@........@.......@@..@....@@@@@@@@@@@@@@@
@@@@@@@@@@@@.@@........@@@.......@@@@....@@@@@@@@@@@@@@@
@@@@.@@@@@@...........@@@@@...............@@@@@@@@@@@@@@
@@@..................@@@@@@@..............@@@@@@@@@@@@@@
@@...................@@@@@@@..............@@@@@@@@@@@@@@
@@@...................@@@@@@@..............@@@@@@@@@@@@@
@@@....................@@@@@@@.@@...........@@@@@@@@@@@@
@@@@..........@@.......@@@@@@@@@@..............@@@@@@@@@
@@@@@........@@@@.......@@@@@@@@@...............@@@@@@@@
@@@@@@......@@@@@........@@@@@@@@................@@@@@@@
@@@@@@@....@@@@.@@........@@@@@@@....@@@@.........@@@@@@
@@@@@@@@..@@@@...@.........@@@@@.....@@@@@@.........@@@@
@@@@@@@@@@@@@@...@@.........@@@@....@@@@@@@............@
@@@@@@@@@@@@@@....@................@@@@@@@............@@
@@@@@@@@@@@@@@@...@@...............@@@@@@@...........@@@
@@@@@@@@@@@@@@@....@@..................@@@..........@@@@
@@@@@@@@@@@@@@@@...@@@.............................@@@@@
@@@@@@@@@@@@@@@@....@.............................@@@@@@
@@@@@@@@@@@@@@@@@...@............................@@@@@@@
@@@@@@@@@@@@@@@@@...@@..........................@@@@@@@@
@@@@@@@@@@@@@@@@@@.............................@@@@@@@@@
@@@@@@@@@@@@@@@@@@@...........................@@@@@@@@@@
@@@@@@@@@@@@@@@@@@...........................@@@@@@@@@@@
@@@@@@@@@@@@@@@@@..........................@@@@@@@@@@@@@
@@@@@@@@@@@@@@@@@.........................@@@@@@@@@@@@@@
@@@@@@@@@@@@@@@@@@.......................@@@@@@@@@@@@@@@
@@@@@@@@@@@@@@@@@@@.....................@@@@@@@@@@@@@@@@
@@@@@@@@@@@@@@@@@@@@...................@@@@@@@@@@@@@@@@@
@@@@@@@@@@@@@@@@@@@@@.................@@@@@@@@@@@@@@@@@@
@@@@@@@@@@@@@@@@@@@@@@...............@@@@@@@@@@@@@@@@@@@
@@@@@@@@@@@@@@@@@@@@@@@.............@@@@@@@@@@@@@@@@@@@@
@@@@@@@@@@@@@@@@@@@@@@@@..........@@@@@@@@@@@@@@@@@@@@@@
@@@@@@@@@@@@@@@@@@@@@@@@@........@@@@@@@@@@@@@@@@@@@@@@@
@@@@@@@@@@@@@@@@@@@@@@@@@@@.....@@@@@@@@@@@@@@@@@@@@@@@@
@@@@@@@@@@@@@@@@@@@@@@@@@@@@@@@@@@@@@@@@@@@@@@@@@@@@@@@@
@@@@@@@@@@@@@@@@@@@@@@@@@@@@@@@@@@@@@@@@@@@@@@@@@@@@@@@@
