snake20x15
.....GGGGGG...GGGGGG
.....GGGGGG...GGGGGG
.....GGGGG....GGGGGG
......GGGG.....GGGGG
.......GGG.....GGGGG
.....E.GG......GGGGG
.......GG....G..GGGG
.....GGG..........GG
.......G......G...<a
..GG.....G....G..GGb
..G..............GGc
....GG...G..........
....................
....................
....................