snake20x12
....................
....................
....................
....................
....................
..cba>..............
..fed>..........E...
..ihg>..............
..lkj>..........GG..
..GGGG.........GGG..
..GGG...........GG..
...G.............G..