snake20x15
....................
....................
....................
....................
.....a>.............
....GGG11...........
.......1............
.......1....GGG.....
.......1............
.....b>1.....E......
....GGGGGGGGGGGG....
....GGG.GGGGGGG.....
.....G..GGGG.G......
.....G..GGG..G......
.....G..GGG..G......