snake18x11
..................
..................
..................
....GGGG..........
....GbGGGG..E.....
....Ga>.<c........
....GGGGGGG.......
..........GGGG....
..................
..................
..................