snake20x14
....................
....................
....................
.....E..............
....................
....GGG.............
....GGG.............
....................
.......11111........
.......1.F.1........
....GGGGGGGG..<ab...
....GGGGGG.GGGGG....
.....G..G..GGGGGG...
.....G..G...GGGGG...