snake20x15
....................
....................
....................
....................
....................
...........E........
....................
...........G........
.......O.G..........
.............O...F..
...a>.GGG........GG.
..GGGGGGG...GGGGGGG.
....GGG.......GGG...
....................
....................