snake20x14
....GGG.............
....GGG.............
....GGG.............
....GGG.............
....GGG.............
....................
.....F..............
............E.......
.........ba>.<e.....
.........cGGGGG.....
.........d.GGG......
....................
....................
....................