snake20x12
....................
....................
....................
....................
...........E........
...........GG.......
.........G.GG.......
......a>...G..F.....
.....GGGGG..........
....GGGGGG.GGGGG....
....GGGGGGGGGGGGG...
....GGGGGGGGGGGGG...