snake20x13
....................
....................
....................
....................
....................
........G...........
........G...O.G.....
......E.O...........
........G...<a......
........GGGGGb......
.........GGG........
....................
....................