snake20x15
....................
....................
....................
...........E........
....................
.........G..G.......
..........1.........
....................
........G...G.......
....................
......ba>.1.........
......GGGGGGGGG.....
......GGGGGGGGG.....
........G...G.......
........G...G.......