snake20x21
........GGGGGGGG....
........GGGGGGGG....
.........GGGGGGGG...
.........GGGGGGGG...
.........GGG...GG...
......E..GGG...GGG..
.........GGG...GGG..
.....GGG.GGG.GGGGG..
....GGGG.....GGGGG..
....G..G.G...GGGG...
....G..G.....GGGG...
...GG..........G....
...GG..G.....G...G..
....G..G............
....G.GG............
....GGG....a>.......
....GGG....bG.......
.....G.....c........
...........d........
...........e........
....................