snake20x15
....................
....................
....................
....................
....................
.........GGG........
.........GGG..E.....
...........1........
.....<a..2.11GG.....
.....b>..22.GG......
....GGG..GGGGG......
......GGGGGGG.......
.......G...G........
.......G...G........
.......G...G........