snake20x11
....................
....................
....................
......a>............
......11.......E....
......b>............
....GGGGG....GGGGG..
....GGGGG..G.GGGGG..
.....G.G...G..G.G...
.....G.G...G..G.G...
.....G.G...G..G.G...