snake20x15
....................
....................
..........F.........
....................
..........F.........
....................
..........F.........
....................
..........F.........
....................
..........F..E......
......ba>...........
......cGGGGGGGG.....
......GGGGGGGGGG....
......GGGGGGGGGG....