snake20x17
....................
....................
....................
..........E.........
....................
....................
..........11........
...........22.......
.........344........
.........55.........
..........667.......
...........88.......
.......a>.99........
......GGGGGGGGG.....
......GGGGGGGGG.....
.........G..G.......
........GG..G.......