snake20x14
....................
....................
....................
....................
..........^.E.......
..........a.........
........cbGGGGG.....
........dvGGG.......
.........GG.........
.....GGGGGG.........
....................
....................
....................
....................