snake20x20
....................
....................
....................
.........E..........
.............G......
....G...GGG.........
....G.G.G......GG...
............G.GG....
.....G...G..........
.............G..G...
....G......G........
....G.G........GG...
.........a>.G...G...
.........bG.........
.......G........GG..
....G......G..G.....
......GG............
..........G.........
....................
....................