snake20x13
....................
....................
....................
....................
......E.............
.......a>...........
.....GGG......F.....
....GGGG.......F....
.....GGGG.....F.F...
.....GGG......GGGG..
......GG....GGGGGGG.
......GGGGGGGGGGGGG.
......GGGGGGGGGGGGG.