snake20x12
....................
............E.......
...........<a.......
.........G.GGG......
.........F...G......
.........G.G........
.........GF.........
.........G.GF.......
.........G..........
.........GG.........
.........GG.........
.........GG.........