snake20x16
....................
....................
....................
....................
....................
......E.............
....G...G...........
....GGGGG...GG......
....GGGGG111GGG.....
....GGGGG111GGG.....
....GGGGGG1GGGG.....
....GGGc...G.G......
.....GGba>GG.G......
.....GGGGGGG.G......
....GGG.G.G..G......
....GGG.G.G..G......