snake20x12
....................
....................
.......E............
....................
......GGG...........
......GG............
....................
...a>...........F...
...GGGG.F....F.GGG..
..GGGGG...GGG..GGG..
..GGGG....GGG..GG...
..GGGG....GGG..GG...