snake20x15
....................
....................
....................
....................
....................
....................
....................
....................
....................
....................
........S...........
..ba>...........E...
.edc>...G...........
.GGGGG..G.....GGGGG.
.GGGGG..G.....GGGGG.