snake20x15
....................
....................
....................
....................
....GG.......E......
....GG111...........
............GGG.....
......111...........
....GGG222..........
............GGG.....
..ba>..222..GGG.....
...GGGGGGG..GGG.....
...GGGGGGG...G......
....G...G....G......
....G...G....G......