snake20x11
....................
....................
.......^...GG.......
.......a...GG.......
......GGGG..G.......
.....GGG............
.....GG.E.F.........
.....GG.............
......GGG.GGG.......
......GGGGGGGG......
......GGGGGGGG......
