snake15x15
...............
...............
...............
...............
...............
......GG.......
...............
.ba>..G...G....
.cGGSSSS.SS....
..G............
...............
........E......
...............
...............
...............