snake16x13
..GGG.GGG.GGG...
..GGG.GGG.GGG...
..GGG.GGG.GGG...
......GGG.GGG...
...E..GGG.GGG...
......G.F...G...
..GGG...G.S.G...
..GGG.S.G.F.....
..GGG.F.G.GSS...
..Ga>.S.........
..GbGGGGG....G..
................
................