snake20x12
....................
....................
....................
..........F.........
....................
........F...........
......G.....E.......
....................
.....GGGba>.GGG.....
....GGGGGGGGGGGG....
.......GGGGGGG......
........GGGG........