snake20x13
....................
....................
....................
....................
....................
....................
.....a>.............
.....GGG............
....GGGGG...E.......
....FFFFFF..........
........GGGGGG......
.........GGGGGG.....
.........GGGGGG.....