snake20x17
....................
....................
....................
...GGGG.............
...GGGG.E...........
..GGGGG.............
..G.G.O.............
..G...GG............
..GGGGGG............
...GGGG.............
....GG......O.......
.............<ab....
.........GGGGGGc....
..........GGGG.de...
....................
....................
....................