snake20x15
....................
....................
....................
....................
......FF............
......GG............
......GG............
....................
..............E.....
....................
.............GGG....
...ba>..<de.........
...cGGGGGGf.........
....................
....................