snake20x19
....................
....................
....................
....................
....................
....................
....................
....................
....................
.........FF.........
.........GG..F......
.........G...G......
......F....F........
......GG.E.GG.F.....
.....F.....G..G.....
.....GGGFa>.FGGG....
....GGGGGGGGGGGG....
....GGGGGGGGGGGG....
....GGGGGGGGGGGG....