snake15x15
...............
...............
...............
.......E.......
...............
.......G.......
...............
.......G.......
...........F...
...F.....SGGG..
..GGGSba>SGGG..
..GGGSGGGSG.G..
..G.G.GGG.G.G..
..G.G.G.G.G.G..
..G.G.G.G.G.G..