snake18x12
..................
..................
..................
..................
..................
......E...........
.........de.......
....ba>..c........
.....GGGGvGGGG....
........GGG.......
..................
..................