snake20x16
.....GGG............
.....GGG............
....................
....................
.....GGG............
.....GGG.E..........
....GGGG............
....G..O............
....G..GG...........
....GGGGG...........
.....GGG....O.......
.....GGG.....<ab....
.....GGG..GGGGGc....
.....GGG...GGG.d....
.....GGG............
.....GGG............