snake20x15
....................
....................
............G.......
............G.......
............G.......
............G.......
............G.......
............G.......
...ba>......G.......
..edc>......G.......
..hgf>.E....G.......
..kji>.........F....
..GGGG........GGG...
..GGGG........GGG...
..GGGG........GGG...