snake20x16
...GGGGGGG..........
...GGGGGGG..........
....GGGGG...........
....GGGGG...........
.....GGG............
.....GGG.E..........
.....G.O............
.....G.GG...........
.....GGG............
.....GGG....O.......
.....GGG......<a....
.....GGG..GGGGGb....
.....GGG...GGG......
.....GGG............
.....GGG............
.....GGG............
