snake20x15
....................
....................
....................
....................
....................
....................
........GG.GG.......
........G.E.G.......
....................
.........a>.........
.........bG.........
.........cFg........
.........def........
....................
....................