snake23x20
..GGGGG..........GGGGGG
.GGGGGG..........GGGGGG
.GGGGGG....11....GGGGGG
.GGGGG......G....GGGGGG
.GGGGG......G....GGGGGG
....a>......22....GGGGG
....b>.......G....GGGG.
....c>.......G.........
....d>.......G.....E...
..GGGG.................
..GGGG...........SGGG..
...GG........SGG..GGGG.
....G.....GG..G...GGGG.
..........GG.......GG..
...GG......G........G..
...GG..............G...
.......................
...G...............G...
.......................
.......................