snake15x15
...............
...............
...............
...............
...............
...............
...ba>.........
...cGGSS.G.....
....GE.S.......
....G..S.......
....GG.........
.....SSSG......
...............
...............
...............