snake20x13
............GGGGGG..
.............GGG....
.............GGGG...
...........F.GGG....
.............GG.....
.............GG.....
.....E.......GG.....
....ba>......GGG....
....111......GGG....
....GG..F..F........
....GG..............
.....GGG..GG........
.....GG.............