type octile
height 21
width 37
map
@@@@@@@@@@@@@@@@@@@@@@@@@@@@@@@@@@@@@
@...................................@
@...................................@
@...................................@
@........@@@@@@@@@@@@@@@@@@@........@
@........@@@@@@@@@@@@@@@@@@@........@
@........@@@@@@@@@@@@@@@@@@@........@
@........@@@@@@@@@@@@@@@@@@@........@
@........@@@@@@@@@@@@@@@@@@@........@
@...................................@
@...................................@
@........@@@@@@@@@@@@@@@@@@@........@
@........@@@@@@@@@@@@@@@@@@@........@
@........@@@@@@@@@@@@@@@@@@@........@
@........@@@@@@@@@@@@@@@@@@@........@
@........@@@@@@@@@@@@@@@@@@@........@
@........@@@@@@@@@@@@@@@@@@@........@
@...................................@
@...................................@
@...................................@
@@@@@@@@@@@@@@@@@@@@@@@@@@@@@@@@@@@@@
