type octile
height 9
width 25
map
@@@@@@@@@@@@@@@@@@@@@@@@@
@.......................@
@..@@@@@@@@@.@@@@@@@@@..@
@..@@@@@@@@@.@@@@@@@@@..@
@.......................@
@..@@@@@@@@@.@@@@@@@@@..@
@..@@@@@@@@@.@@@@@@@@@..@
@.......................@
@@@@@@@@@@@@@@@@@@@@@@@@@
