type octile
height 5
width 6
map
@@@@@@
@....@
@....@
@....@
@@@@@@
