type octile
height 9
width 50
map
@@@@@@@@@@@@@@@@@@@@@@@@@@@@@@@@@@@@@@@@@@@@@@@@@@
@.....SSSSSSSSSSSSSSSSSSSSSSSSSSSSSSSSSSSSSS.....@
@.....SSSSSSSSSSSSSSSSSSSSSSSSSSSSSSSSSSSSSS.....@
@.....@@@@@@@@@@@@@@@.@@@@@@@@@@@@@@@@@@@@@@.....@
@.....@@@@@@@@@@@@@@@.@@@@@@@@@@@@@@@@@@@@@@.....@
@.....@@@@@@@@@@@@@@@.@@@@@@@@@@@@@@@@@@@@@@.....@
@.....@@@@@@@@@@@@@@@.@@@@@@@@@@@@@@@@@@@@@@.....@
@.....@@@@@@@@@@@@@@@.@@@@@@@@@@@@@@@@@@@@@@.....@
@@@@@@@@@@@@@@@@@@@@@@@@@@@@@@@@@@@@@@@@@@@@@@@@@@
