snake18x14
....GGGG..........
....GGGG..........
....GGGG..........
....GGGG..........
....GGGG..........
....GGGG...G......
...........G......
..E.......<ab.....
...........Gc.....
...........G......
GGG.......<de.....
.GGG.......Gf.....
...........Gg.....
...........G......
...........G......
