snake20x13
....................
....................
....................
....................
...........E........
.........G..........
........F..FG.......
....................
........SG..G.......
.........a>SS.......
.........bGS........
....................
....................
