snake20x19
....................
....................
....................
............F.......
...........GG.......
...........GG.......
...........GG.......
....................
....................
.........S....S.....
.........GG..GG.....
.........S..1.S.....
....................
.........a>.1.<bE...
.........GGGGGGc....
.........GGGGGGd....
.........GGGGGG.....
..........G..G......
..........G..G......
