snake20x16
.......G............
.......G............
.......S............
......d.^...........
......cba...........
.......G............
............S.......
..............E.....
....SGS..SSSG.......
...........GG.......
....................
....F...S...........
.......GSF..........
.......GGG..........
.......GGG..........
.......GGG..........
