snake20x16
....................
....................
.............GGG....
.............GGGG...
.............SGGG...
.............S......
.......F.....S.E....
....<a..............
.....^.......SGGG...
.....b.......SGGG...
.....c1......SGGG...
.....GSSSSSSSSGG....
.....GGG..GGGGGGG...
.....GGG..GGGGGGG...
......GGG..G...G....
......GGG..G...G....

