snake20x13
....................
....................
.........GG.........
.........GG.........
........GG..........
.......GGG..........
........GF.G........
........G.....E.....
......a>...G........
......bGGS..........
......c.GGG.........
....................
....................
