snake20x16
....................
....................
....................
......E.............
....................
......SSSGGGGG......
......F...OG.G......
......GSS..F.G......
..........G..G......
......G......G......
...S...O.....G......
..........<a.G......
.....SSGSGGb.G......
.....GGG.GG..G......
....................
....................
