snake20x13
....................
....................
...........SSG......
...........GGG......
............G.......
.......G.a>.G.E.....
.....G...<b.........
.......FSFG..G......
......S......G......
......GG.G...G......
......GG.G...G......
......GG.G...G......
......GG.G...G......

