snake20x15
....................
....................
....................
....................
.........ba>.E......
.........cG.........
....................
.......GS...SG......
........S...........
........SSGS........
..........F.........
............G.......
...........GG.......
...........GG.......
...........GG.......
