snake20x18
....................
....................
....................
....................
....................
....................
...........G........
...........G........
...........G....E...
....................
........G.....G.....
.......ba>..........
......Gc.f..........
......G<de..........
......GGGG..........
....................
