snake20x17
....................
....................
....................
....................
..........GS........
..........GS........
...........S<ab.....
............e>c.....
......GGS..SGGd.....
......GGSS.SGG......
.......GS..SG.......
...........E........
...........S........
..........GS........
..........GS........
.........SSS........
....................
