snake19x14
....................
....................
....................
....................
....................
....................
....................
............S.......
.....E...c>.........
.........a>.G.......
.........bG.G.......
......G...G.G.......
......G...G.G.......
......G...G.G.......
