snake20x16
....................
....................
....................
....................
.........E..........
....................
....................
....................
....................
......ba>...........
.......GG...11......
.......GG.G.11......
.......GG...GG......
.......GGGGGGG......
.......GGGGGGG......
........G...G.......
