snake20x13
....................
....................
....................
....................
...........E........
....................
........F.......F...
.........S.<abSGG...
.........SGGGGGGG...
.......GGGG.GGGGG...
.......GGG..GGGG....
........G....GGG....
........G....GGG....


