snake20x15
....................
....................
.........G..........
.........G..........
...GGGGG............
...G...G............
.....O...G..........
.....G...G..........
.....G<abO..E.......
.....Gdc>G..........
.....GGGGG..........
....................
....................
....................
....................
