snake20x17
........GGGGGGGGGGGG
.........GGGGGGGGGG.
.........GGGGGGGGGG.
..........1GGGGG.G..
..........1.....E...
..........1.S...G...
..........G.GG......
..........GO.G......
..........G..G......
..........GGSG......
............O.......
....................
...........ba>f.....
...........c<de.....
...........GGGG.....
............GG......
....................
