snake20x13
....................
....................
....................
....................
.........E........G.
..................G.
....................
......a>....<c...G..
G.....bF....Fd...GG.
G........G.......GG.
GG.......G.......GG.
GG.......G.......GG.
GG.......G.......GG.
