snake20x15
....................
....................
....................
....................
....................
....................
.............GG.....
............GGGG....
.....a>.....GF.G....
...E.b>....F...G....
.....GG...G.GGGG....
.....GGS......GG....
.....GGGG..G..GG....
.....GGG...G..GG....
.....GGG...G..GG....
