snake20x20
....................
....................
....................
....................
..........E.........
....................
..........G.........
....................
....................
....................
....................
..........1.........
.........GGG........
........1...1.......
....................
.......a>.1.<d......
.......bG...Ge......
.......cG...G.......
........G...G.......
........G...G.......
