snake20x19
....................
....................
....................
...........1........
..........S2........
...........2........
.........G.G...E....
.........S..........
.........S..........
......ba>..S<de.....
......cGSSF.GG......
.......GG...GG......
.......G.....G......
..........F.........
....................
....................
..........G.........
.........SGS........
..........G.........
