snake20x13
.......GGG..GGG.....
.......GGG..GGG.....
.......GGG..........
....................
.............G......
........G....G......
......E.G...1O......
........G<a.GGG.....
........Ob>.G.G.....
.....GGGGGGSS.......
......G..G..........
....................
....................
