snake20x13
....................
..........GGGG......
...........GG.......
....................
..............O.....
..............G.....
............^.G.....
.....E...O..a.......
.........G..bc......
.........GGGGGG.....
...........GG.......
....................
....................
