snake20x13
....................
....................
....................
....................
....................
.................E..
....................
.....ba>........GGG.
....dc<ef.....SSSGG.
...GGGGGGSSS..S.....
....GGGGG..SSGS.....
....................
....................
