snake20x14
....................
....................
....................
..........E.........
..........S.........
........F.G.F.......
....................
....................
.........a>.........
......SSSbG..SS.....
......GGGcF.SSG.....
......GG.de..GG.....
......GG.....GG.....
......GG.....GG.....
