snake13x19
...................
...................
...................
.....GG............
.....GGG...........
....GGGG..E........
...GGGGG...........
...GG.FG...b.......
...GG.....<a.F.....
..GGG..GGGGG.......
..GGGGGGG.GG.......
..GGGGGGG..G.......
..GGGGGG...G.......
