snake20x20
.......GGGGGGG......
........GGGGG.......
........GGGGG.......
....................
............G.......
............S.......
.............F......
..........O.G.......
............G.......
....................
.......E.ba>........
.........cG.........
..........G.........
...........O........
..........SS........
..........F.........
..........GG........
..........GG........
..........GG........
..........GG........
