snake20x13
....................
....................
....................
....................
........E...........
....................
........G....GOG....
.......O............
......<abc...G......
.....GG.G....G......
......G.G....G......
......G.G....G......
......G.G....G......
