snake20x15
....................
....................
....................
............E.......
.....O..............
..........<abc......
..........GGGGG.....
..........O.G.......
..........G.G.......
.....fed>.GGG.......
....GGGGGGG.........
....................
....................
....................
....................
