snake20x18
....................
....................
....................
..........E.........
....................
....................
....................
....................
....................
.......<ab..........
.......11...........
.......11...........
.....223344.........
.....223344.<cd.....
.....GGGGG..GG......
.....GGGGGGGGGG.....
.....GGGGG.GGGG.....
......G.G..GGGGG....
