snake19x14
...................
...................
...................
...........E.......
...................
........G..........
...................
.....G.............
.....G.............
.....G..G...<ab....
........G..<dec....
...........GGGG....
