type octile
height 54
width 56
map
@@@@@@@@@@@@@@@@@@@@@@@@@@@@@@@@@@@@@@@@@@@@@@@@@@@@@@@@
@@@@@@@@@@@@@@@@@@@@@@@@@@@@@@@@@@@@@@@@@@@@@@@@@@@@@@@@
@@@@@@@@@@@@@@@@@@@@@@@@@@@@@@@@@@@@@@@@@@@@@@@@@@@@@@@@
@@@@@@@@@@@@@@@@@@@@@@@@@@@@@@@@@@@@@@@@@@@@@@@@@@@@@@@@
@@@@@@@@@@@@@@@@@@@@@@@@@@@@@@@@@@@@@@@@@@@@@@@@@@@@@@@@
@@@@@@@@@@@@@@@@@@@@@@@@@@@@@@@@@@@@@@@@@@@@@@@@@@@@@@@@
@@@@@@@@@@@@@@@@@@@@@@@@@@@@@@@@@@@@@@@@@@@@@@@@@@@@@@@@
@@@@@@@@@@@@@@@@@@@@@@@@@@@@@@@@@@@@@@@@@@@@@@@@@@@@@@@@
@@@@@@@@@@@@@@@@@@@@@@@@@@@@@@@@@@@@@@@@@@@@@@@@@@@@@@@@
@@@@@@@@@@@@@@@@@@@@@@@@@@@@@@@@@@@@@@@@@@@@@@@@@@@@@@@@
@@@@@@@@@@@@@@@@@@@@@..@@@@@@@@@@@@@@@@@@@@@@@@@@@@@@@@@
@@@@@@@@@@@@@@@@@@@@....@@@@@@@@@@@@@@@@@@@@@@@@@@@@@@@@
@@@@@@@@@@@@@@@@@@@......@@@@@@@@@@@@@@@.@@@@@@@@@@@@@@@
@@@@@@@@@@@@@@@@@@........@@@@@@@@@@@@@...@@@@@@@@@@@@@@
@@@@@@@@@@@@@@@@@..........@@@@@@@@@@@.....@@@@@@@@@@@@@
@@@@@@@@@@@@@@@@....@@......@@@@@@@@@@.....@@@@@@@@@@@@@
@@@@@@@@@@@@@@@....@@@.......@@@@@@@@......@@@@@@@@@@@@@
@@@@@@@@@@@@@@....@@@@........@@@@@@.......@@@@@@@@@@@@@
@@@@@@@@@@@@@.....@@@..........@@@@........@@@@@@@@@@@@@
@@@@@@@@@@@@.......@............@@......@@@@@@@@@@@@@@@@
@@@@@@@@@@.............................@@@@@@@@@@@@@@@@@
@@@@@@@@@..............................@@@@@@@@@@@@@@@@@
@@@@@@@@.................@@@@...........@@....@@@@@@@@@@
@@@@@@@@@................@@@@@...............@@@@@@@@@@@
@@@@@@@@@@..............@@@@@@@.............@@@@@@@@@@@@
@@@@@@@@@@@.............@@@@@@@@...........@@@@@@@@@@@@@
@@@@@@@@@@@@@....@......@@@@@@@@@........@@@@@@@@@@@@@@@
@@@@@@@@@@@@@@@..@@......@@@@@@@@@......@@@@@@@@@@@@@@@@
@@@@@@@@@@@@@@@...@@......@@@@@@@@@....@@@@@@@@@@@@@@@@@
@@@@@@@@@@@@@@@@..@@@......@@@@@@@@.....@@@@@@@@@@@@@@@@
@@@@@@@@@@@@@@@@..@@@@......@@@@@@.......@@@@@@@@@@@@@@@
@@@@@@@@@@@@@@@@@.@@@@@......@@@@.........@@@@@@@@@@@@@@
@@@@@@@@@@@@@@@@@@@@@@@@.....@@@...........@@@@@@@@@@@@@
@@@@@@@@@@@@@@@@@@@@@@@@....................@@@@@@@@@@@@
@@@@@@@@@@@@@@@@@@@@@@@@.....................@@@@@@@@@@@
@@@@@@@@@@@@@@@.@@@@@@@@......................@@@@@@@@@@
@@@@@@@@@@@@..................................@@@@@@@@@@
@@@@@@@@@@...........................@.......@@@@@@@@@@@
@@@@@@@@............................@@@.....@@@@@@@@@@@@
@@@@@@@....@@.......................@@@@...@@@@@@@@@@@@@
@@@@@@....@@.........................@@@@.@@@@@@@@@@@@@@
@@@@@@...................@............@@@@@@@@@@@@@@@@@@
@@@@@@..................@@@............@@@@@@@@@@@@@@@@@
@@@@@@.................@@@@@...........@@@@@@@@@@@@@@@@@
@@@@@@@...............@@@@@@@.........@@@@@@@@@@@@@@@@@@
@@@@@@@@.............@@@@@@@@@.......@@@@@@@@@@@@@@@@@@@
@@@@@@@@@...........@@@@@@@@@@@@....@@@@@@@@@@@@@@@@@@@@
@@@@@@@@@@.........@@@@@@@@@@@@@@.@@@@@@@@@@@@@@@@@@@@@@
@@@@@@@@@@@.......@@@@@@@@@@@@@@@@@@@@@@@@@@@@@@@@@@@@@@
@@@@@@@@@@@@....@@@@@@@@@@@@@@@@@@@@@@@@@@@@@@@@@@@@@@@@
@@@@@@@@@@@@@@.@@@@@@@@@@@@@@@@@@@@@@@@@@@@@@@@@@@@@@@@@
@@@@@@@@@@@@@@@@@@@@@@@@@@@@@@@@@@@@@@@@@@@@@@@@@@@@@@@@
@@@@@@@@@@@@@@@@@@@@@@@@@@@@@@@@@@@@@@@@@@@@@@@@@@@@@@@@
@@@@@@@@@@@@@@@@@@@@@@@@@@@@@@@@@@@@@@@@@@@@@@@@@@@@@@@@
