type octile
height 102
width 92
map
@@@@@@@@@@@@@@@@@@@@@@@@@@@@@@@@@@@@@@@@@@@@@@@@@@@@@@@@@@@@@@@@@@@@@@@@@@@@@@@@@@@@@@@@@@@@
@@@@@@@@@@@@@@@@@@@@@@@@@@@@@@@@@@@@@@@@@@@@@@@@@@@@@@@@@@@@@@@@@@@@@@@@@@@@@@@@@@@@@@@@@@@@
@@@@@@@@@@@@@@@@@@@@@@@@@@@@@@@@@@@@@@@@@@@@@@@@@@@@@@@@@@@@@@@@@@@@@@@@@@@@@@@@@@@@@@@@@@@@
@@@@@@@@@@@@@@@@@@@@@@@@@@@@@@@@@@@@@@@@@@@@@@@@@@@@@@@@@@@@@@@@@@@@@@@@@@@@@@@@@@@@@@@@@@@@
@@@@@@@@@@@@@@@@@@@@@@@@@@@@@@@@@@@@@@@@@@@@@@@@@@@@@@@@@@@@@@@@@@@@@@@@@@@@@@@@@@@@@@@@@@@@
@@@@@@@@@@@@@@@@@@@@@@@@@@@@@@@@@@@@@@@@@@@@@@@@@@@@@@@@@@@@@@@@@@@@@@@@@@@@@@@@@@@@@@@@@@@@
@@@@@@@@@@@@@@@@@@@@@@@@@@@@@@@@@@@@@@@@@@@@@@@@@@@@@@@@@@@@@@@@@@@@@@@@@@@@@@@@@@@@@@@@@@@@
@@@@@@@@@@@@@@@@@@@@@@@@@@@@@@@@@@@@@@@@@@@@@@@@@@@@@@@@@@@@@@@@@@@@@@@@@@@@@@@@@@@@@@@@@@@@
@@@@@@@@@@@@@@@@@@@@@@@@@@@@@@@@@@@@@@@@@@@@@@@@@@@@@@@@@@@@@@@@@@@@@@@@@@@@@@@@@@@@@@@@@@@@
@@@@@@@@@@@@@@@@@@@@@@@@@@@@@@@@@@@@@@@@@@@@@@@@@@@@@@@@@@@@@@@@@@@@@@@@@@@@@@@@@@@@@@@@@@@@
@@@@@@@@@@@@@@@@@@@@@@@@@@@@@@@@@@@@@@@@@@@@@@@@@@@@@@@@@@@@@@@@@@@@@@@@@@@@@@@@@@@@@@@@@@@@
@@@@@@@@@@@@@@@@@@@@@@@@@@@@@@@@@@@@@@@@@@@@@@@@@@@@@@@@@@@@@@@@@@@@@@@@@@@@@@@@@@@@@@@@@@@@
@@@@@@@@@@@@@@@@@@@@@@@@@@@@@@@@@@@@@@@@@@@@@@@@@@@@@@@@@@@@@@@@@@@@@@@@@@@@@@@@@@@@@@@@@@@@
@@@@@@@@@@@@@@@@@@@@@@@@@@@@@@@@@@@@@@@@@@@@@@@@@@@@@@@@@@@@@@@@@@@@@@@@@@@@@@@@@@@@@@@@@@@@
@@@@@@@@@@@@@@@@@@@@@@@@@@@@@@@@@@@@@@@@@@@@@@@@@@@@@@@@@@@@@@@@@@@@@@@@@@@@@@@@@@@@@@@@@@@@
@@@@@@@@@@@@@@@@@@@@@@@@@@@@@@@@@@@@@@@@@@@@@@@@@@@@@@@@@@@@@@@@@@@@@@@@@@@@@@@@@@@@@@@@@@@@
@@@@@@@@@@@@@@@@@@@@@@@@@@@@@@@@@@@@@@@@@@@@@@@@@@@@@@@@@@@@@@@@@@@@@@@@@@@@@@@@@@@@@@@@@@@@
@@@@@@@@@@@@@@@@@@@@@@@@@@@@@@@@@@@@@@@@@@@@@@@@@@@@@@@@@@@@@@@@@@@@@@@@@@@@@@@@@@@@@@@@@@@@
@@@@@@@@@@@@@@@@@@@@@@@@@@@@@@@@@@@@@@@@@@@@@@@@@@@@@@@@@@@@@@@@@@@@@@@@@@@@@@@@@@@@@@@@@@@@
@@@@@@@@@@@@@@@@@@@@@@@@@@@@@@@@@@@@@@...................@@@@@@@@@@@@@@@@@@@@@@@@@@@@@@@@@@@
@@@@@@@@@@@@@@@@@@@@@@@@@@@@@@@@@..........................@@@@@@@@@@@@@@@@@@@@@@@@@@@@@@@@@
@@@@@@@@@@@@@@@@@@@@@@@@@@@@@..............................@@@@@@@@@@@@@@@@@@@@@@@@@@@@@@@@@
@@@@@@@@@@@@@@@@@@@@@@@@@@@................................@@@@@@@@@@@@@@@@@@@@@@@@@@@@@@@@@
@@@@@@@@@@@@@@@@@@@@@@@@@..................................@@@@@@@@@@@@@@@@@@@@@@@@@@@@@@@@@
@@@@@@@@@@@@@@@@@@@@@@@....................................@@@@@@@@@@@@@@@@@@@@@@@@@@@@@@@@@
@@@@@@@@@@@@@@@@@@@@@......................................@@@@@@@@@@@@@@@@@@@@@@@@@@@@@@@@@
@@@@@@@@@@@@@@@@@@@@.......................................@@@@@@@@@@@@@@@@@@@@@@@@@@@@@@@@@
@@@@@@@@@@@@@@@@@@@........................................@@@@@@@@@@@@@@@@@@@@@@@@@@@@@@@@@
@@@@@@@@..@@@@@@@........................@@.......@@.......@@@@@@@@@@@@@@@@@@@@@@@@@@@@@@@@@
@@@@@@@@...@@@@@........................@@@@.....@@@@......@@@@@@@@@@@@@@@@@@@@@@@@@@@@@@@@@
@@@@@@@....@@@@.................@@.........................@@@@@..@@@@@@@@@@@@@@@@@...@@@@@@
@@@@@@@.....@@.................@@@@....@@@@@@@@@@@@@@......@@@@@...@@@@@@@@@@@@@@@.....@@@@@
@@@@@@..........................@@@@@@@@@@@@@@@@@@@@@@@@@..@@@@@...@@@@@@@@@@@@@@......@@@@@
@@@@@@..................@@......@@@@@@@@@@@@@@@@@@@@@@@@@@@@@@@@....@@@@@@@@@@@@.......@@@@@
@@@@@@..................@@@..@@@@@@@@@@@@@@@@@@@@@@@@@@@@@@@@@@@....@@@@@@@@@@@........@@@@@
@@@@@..................@@@@@@@@@@@@@@@@@@@@@@@@@@@@@@@@@@@@@@@@@....@@@@@@@@@@.........@@@@@
@@@@@....................@@@@@@@@@@@@@@@@@@@@@@@@@@@@@@@@@@@@@@.....@@@@@@@@@...........@@@@
@@@@...................@@@@@@@@@@@@@@@@@@@@@@@@@@@@@@@@@@@@@@@......@@@@@@@@............@@@@
@@@@..................@@@@@@@@@@@@@@@@@@@@@@@@@@@@@@@@@@@@@@@.......@@@@@@@@............@@@@
@@@@.............@@@@@@@@@@@@@@@@@@@@@@@@@@@@@@@@@@@@@@@@@@@........@@@@@@@@.............@@@
@@@@.............@@@@@@@@@@@@@@@@@@@@@@@@@@@@@@@@@@@@@@@@@@........@@@@@@@@@.............@@@
@@@..............@@@@@@@@@@@@@@@@@@@@@@@@@@@@@@@@@@@@@@@@@.........@@@@@@@@@.............@@@
@@@.................@@@@@@@@@@@@@@@@@@@@@@@@@@@@@@@@@@@@@@........@@@@@@@@@@.............@@@
@@@..................@@@@@@@@@@@@@@@@@@@@@@@@@@@@@@@@@@@@........@@@@@@@@@...............@@@
@@@....................@@@@@@@@@@@@@@@@@@@@@@@@@@@@@@@@@........@@@@@@@@@@@..............@@@
@@@......................@@@@@@@@@@@@@@@@@@@@@@@@@@@@@@.........@@@@@@@@@@@@.............@@@
@@@........................@@@@@@@@@@@@@@@@@@@@@@@@@@@.........@@@@@@@@@@@@@@.@@.........@@@
@@@.........@@@@............@@@@@@@@@@@@@@@@@@@@@@@@@.........@@@@@@@@@@@@@@@@@@.........@@@
@@@........@@@@@@.............@@@@@@@@@@@@@@@@@@@@@@@........@@@@@@@@@@@@@@@@@@@@........@@@
@@@..........@@@@@@.............@@@@@@@@@@@@@@@@@@@@.........@@@@@@@@@@@@@@@@@@@@........@@@
@@@..........@@@@@@@.............@@@@@@@@@@@@@@@@@@.........@@@@@@@@@@@@@@@@@@@..........@@@
@@@..........@@@@@@@@@............@@@@@@@@@@@@@@@@.........@@@@@@@@@@@@@@@@@@@@..........@@@
@@@.........@@@@@@@@@@@.............@@@@@@................@@@@@@@@@@@@@@@@@@@@@@.........@@@
@@@.........@@@@@@@@@@@@@............@@...................@@@@@@@@@@@@@@@@@@@@@@.........@@@
@@@.........@@@@@@@@@@@@@@...............................@@@@@@@@@@@@@@@@@@@@@@@@........@@@
@@@........@@@@@@@@@@@@@@@@@.............................@@@@@@@@@@@@@@@@@@@@@@@@........@@@
@@@........@@@@@@@@@@@@@@@@@@............................@@@@@@@@@@@@@@@@@@@@@@@@@.......@@@
@@@........@@@@@@@@@@@@@@@@@@@@...........................@@@@@@@@@@@@@@@@@@@@@@@@.......@@@
@@@........@@@@@@@@@@@@@@@@@@@@@..........................@@@@@@@@@@@@@@@@@@@@@@@@.......@@@
@@@........@@@@@@@@@@@@@@@@@@@@@@...........@@@@...........@@@@@@@@@@@@@@@@@@@@@@@.......@@@
@@@.........@@@@@@@@@@@@@@@@@@@@@.........@@@@@@@@.........@@@@@@@@@@@@@@@@@@@@@@@.......@@@
@@@.........@@@@@@@@@@@@@@@@@@@@@........@@@@@@@@@@........@@@@@@@@@@@@@@@@@@@@@@@.......@@@
@@@.........@@@@@@@@@@@@@@@@@@@@@.......@@@@@@@@@@@........@@@@@@@@@@@@@@@@@@@@@@@.......@@@
@@@.........@@@@@@@@@@@@@@@@@@@@@.......@@@@@@@@@@@........@@@@@@@@@@@@@@@@@@@@@@@.......@@@
@@@.........@@@@@@@@@@@@@@@@@@@@@.......@@@@@@@@@@@........@@@@@@@@@@@@@@@@@@@@@@@.......@@@
@@@..........@@@@@@@@@@@@@@@@@@@@.......@@@@@@@@@@@........@@@@@@@@@@@@@@@@@@@@@@@.......@@@
@@@..........@@@@@@@@@@@@@@@@@@@@........@@@@@@@@@@........@@@@@@@@@@@@@@@@@@@@@@@.......@@@
@@@..........@@@@@@@@@@@@@@@@@@@@........@@@@@@@@@.........@@@@@@@@@@@@@@@@@@@@@@........@@@
@@@...........@@@@@@@@@@@@@@@@@@@@........@@@@@@@..........@@@@@@@@@@@@@@@@@@@@@@........@@@
@@@............@@@@@@@@@@@@@@@@@@@.........@@@@@.............@@@@@@@@@@@@@@@@@@@@........@@@
@@@............@@@@@@@@@@@@@@@@@@@@...........................@@@@@@@@@@@@@@@@@@@........@@@
@@@.............@@@@@@@@@@@@@@@@@@@.............................@@@@@@@@@@@@@@@@.........@@@
@@@.............@@@@@@@@@@@@@@@@@@................................@@@@@@@@@@@@@..........@@@
@@@..............@@@@@@@@@@@@@@@@@...................@@.............@@@@@@@@@@...........@@@
@@@...............@@@@@@@@@@@@@@@@.................@@@@@.............@@@@@@@@@...........@@@
@@@...............@@@@@@@@@@@@@@@.........@@....@@@@@@@@@@.............@@@@@@............@@@
@@@................@@@@@@@@@@@@@.........@@@@@@@@@@@@@@@@@@..............@@@.............@@@
@@@.................@@@@@@@@@@@@........@@@@@@@@@@@@@@@@@@@@@............................@@@
@@@.................@@@@@@@@@@@........@@@@@@@@@@@@@@@@@@@@@@@...........................@@@
@@@..................@@@@@@@@@.........@@@@@@@@@@@@@@@@@@@@@@@@..........................@@@
@@@...................@@@@@@@@........@@@@@@@@@@@@@@@@@@@@@@@@@@.........................@@@
@@@@..................@@@@@@.........@@@@@@@@@@@@@@@@@@@@@@@@@@@@........................@@@
@@@@@@..................@@..........@@@@@@@@@@@@@@@@@@@@@@@@@@@@@@......................@@@@
@@@@@@.............................@@@@@@@@@@@@@@@@@@@@@@@@@@@@@@@.....................@@@@@
@@@@@@@...........................@@@@@@@@@@@@@@@@@@@@@@@@@@@@@@@.....................@@@@@@
@@@@@@@@@........................@@@@@@@@@@@@@@@@@@@@@@@@@@@@@@@@....................@@@@@@@
@@@@@@@@@@......................@@@@@@@@@@@@@@@@@@@@@@@@@@@@@@@@....................@@@@@@@@
@@@@@@@@@@@@......................@@@@@@@@@@@@@@@@@@@@@@@@@@@@@...................@@@@@@@@@@
@@@@@@@@@@@@@@.....................@@@@@@@@@@@@@@@@@@@@@@@@......................@@@@@@@@@@@
@@@@@@@@@@@@@@@...........................@@@@@@@@@@@@@@@......................@@@@@@@@@@@@@
@@@@@@@@@@@@@@@@@@............................................................@@@@@@@@@@@@@@
@@@@@@@@@@@@@@@@@@@........................................................@@@@@@@@@@@@@@@@@
@@@@@@@@@@@@@@@@@@@@...................................................@@@@@@@@@@@@@@@@@@@@@
@@@@@@@@@@@@@@@@@@@@@@..............................................@@@@@@@@@@@@@@@@@@@@@@@@
@@@@@@@@@@@@@@@@@@@@@@@............................................@@@@@@@@@@@@@@@@@@@@@@@@@
@@@@@@@@@@@@@@@@@@@@@@@@@@@....................................@@@@@@@@@@@@@@@@@@@@@@@@@@@@@
@@@@@@@@@@@@@@@@@@@@@@@@@@@@@@..............................@@@@@@@@@@@@@@@@@@@@@@@@@@@@@@@@
@@@@@@@@@@@@@@@@@@@@@@@@@@@@@@@@..........................@@@@@@@@@@@@@@@@@@@@@@@@@@@@@@@@@@
@@@@@@@@@@@@@@@@@@@@@@@@@@@@@@@@@@@@....................@@@@@@@@@@@@@@@@@@@@@@@@@@@@@@@@@@@@
@@@@@@@@@@@@@@@@@@@@@@@@@@@@@@@@@@@@@@@@@@@@@@@@@@@@@@@@@@@@@@@@@@@@@@@@@@@@@@@@@@@@@@@@@@@@
@@@@@@@@@@@@@@@@@@@@@@@@@@@@@@@@@@@@@@@@@@@@@@@@@@@@@@@@@@@@@@@@@@@@@@@@@@@@@@@@@@@@@@@@@@@@
@@@@@@@@@@@@@@@@@@@@@@@@@@@@@@@@@@@@@@@@@@@@@@@@@@@@@@@@@@@@@@@@@@@@@@@@@@@@@@@@@@@@@@@@@@@@
