type octile
height 54
width 52
map
@@@@@@@@@@@@@@@@@@@@@@@@@@@@@@@@@@@@@@@@@@@@@@@@@@@@
@@@@@@@@@@@@@@@@@@@@@@@@@@@@@@@@@@@@@@@@@@@@@@@@@@@@
@@@@@@@@@@@@@@@@@@@@@@@@@@@@@@@@@@@@@@@@@@@@@@@@@@@@
@@@@@@@@@@@@@@@@@@@@@@@@@@@@@@@@@@@@@@@@@@@@@@@@@@@@
@@@@@@@@@@@@@@@@@@@@@@@@@@@@@@@@@@@@@@@@@@@@@@@@@@@@
@@@@@@@@@@@@@@@@@@@@@@@@@@@@@@@@@@@@@@@@@@@@@@@@@@@@
@@@@@@@@@@@@@@@@@@@@@@@@@@@@@@@@@@@@@@@@@@@@@@@@@@@@
@@@@@@@@@@@@@@@@@@@@@@@@@@@@@@@@@@@@@@@@@@@@@@@@@@@@
@@@@@@@@@@@@@@@@@@@@@@@@@@@@@@@@@@@@@@@@@@@@@@@@@@@@
@@@@@@@@@@@@@@@@@@@@@@@@@@@@@@@@@@@@@@@@@@@@@@@@@@@@
@@@@@@@@@@@@@@@@@@@@@@@@@@@@@@@@@@@@@@@@@@@@@@@@@@@@
@@@@@@@@@@@@@@@@@@@@@@@@@@@@@@@@@@@@@@@@@@@@@@@@@@@@
@@@@@@@@@@@@@@@@@@@@@@@@@@@@@@@@@@@@@@@@@@@@@@@@@@@@
@@@@@@@@@@@@@@@@@@@@@@@@@@@@@.@@@@@@@@@@@@@@@@@@@@@@
@@@@@@@@@@@@@@@@@@@@@@@@@@@@....@@@@@@@@@@@@@@@@@@@@
@@@@@@@@@@@@@@@@@@@@@@@@@@@@@.....@@@@@@@@@@@@@@@@@@
@@@@@@@@@@@@@@@@@@@@@@@@@@@@@@....@@@@@@@@@@@@@@@@@@
@@@@@@@@@@@@@@@@@@@@@@@@@@@@@........@@@@@@@@@@@@@@@
@@@@@@@@@@@@@@@@@@@@@@@@@@...........@@@@@@@@@@@@@@@
@@@@@@@@@@@@@@@@@@@@@@@@@@.............@@@@@@@@@@@@@
@@@@@@@@@@@@@@@@@@@@@@@@@@..............@@@@@@@@@@@@
@@@@@@@@@@@@@@@@@@@@@@@@..................@@@@@@@@@@
@@@@@@@@@@@@@@@@@@@@@@@....................@@@@@@@@@
@@@@@@@@@@@@@@@@@@@@@@......................@@@@@@@@
@@@@@@@@@@@@@@@@@.@@@@.......................@@@@@@@
@@@@@@@@@@@@@@@@...@@@..@@@@..................@@@@@@
@@@@@@@@@@@@@@@.........@@@@@.................@@@@@@
@@@@@@@@@@@@@@.........@@@@@@@................@@@@@@
@@@@@@@@@@@@@.........@@@@@@@@@..............@@@@@@@
@@@@@@@@@@@@@........@@@@@@@@@@.............@@@@@@@@
@@@@@@@@@@@@@@.......@@@@@@@@@.............@@@@@@@@@
@@@@@@@@@@@@@@@......@@@@@@@@.............@@@@@@@@@@
@@@@@@@@@@@@@@.......@@@@@@@@............@@@@@@@@@@@
@@@@@@@@@@@@@........@@@@@@.............@@@@@@@@@@@@
@@@@@@@@@@@@...........................@@@@@@@@@@@@@
@@@@@@@@@@@...........................@@@@@@@@@@@@@@
@@@@@@.@@@...........................@@@@@@@@@@@@@@@
@@@@@@..@...........................@@@@@@@@@@@@@@@@
@@@@@@.............................@@@@@@@@@@@@@@@@@
@@@@@@............................@@@@@@@@@@@@@@@@@@
@@@@@@...........................@@@@@@@@@@@@@@@@@@@
@@@@@@..........................@@@@@@@@@@@@@@@@@@@@
@@@@@@@........................@@@@@@@@@@@@@@@@@@@@@
@@@@@@@@......................@@@@@@@@@@@@@@@@@@@@@@
@@@@@@@@@....................@@@@@@@@@@@@@@@@@@@@@@@
@@@@@@@@@@..................@@@@@@@@@@@@@@@@@@@@@@@@
@@@@@@@@@@@................@@@@@@@@@@@@@@@@@@@@@@@@@
@@@@@@@@@@@@..............@@@@@@@@@@@@@@@@@@@@@@@@@@
@@@@@@@@@@@@@............@@@@@@@@@@@@@@@@@@@@@@@@@@@
@@@@@@@@@@@@@@..........@@@@@@@@@@@@@@@@@@@@@@@@@@@@
@@@@@@@@@@@@@@@........@@@@@@@@@@@@@@@@@@@@@@@@@@@@@
@@@@@@@@@@@@@@@@......@@@@@@@@@@@@@@@@@@@@@@@@@@@@@@
@@@@@@@@@@@@@@@@@....@@@@@@@@@@@@@@@@@@@@@@@@@@@@@@@
@@@@@@@@@@@@@@@@@@@@@@@@@@@@@@@@@@@@@@@@@@@@@@@@@@@@
