type octile
height 25
width 25
map
@@@@@@@@@@@@@@@@@@@@@@@@@
@@@@@@@@@@@@@@@@@@@@@@@@@
@@@@@@@@@@@@@@@@@@@@@@@@@
@@@@@@@@@@@@@@@@@@@@@@@@@
@@@@@@@@@@@@@@@@@@@@@@@@@
@@@@@@@@@@@@@@@@@@@@@@@@@
@@@@@@@@@@@@@@@........@@
@@@@@@@@@@@@@@@.@@@@@@S@@
@@@@@@@@@@@@@@@.@@@@@@S@@
@@@@@@@@@@@@@@@.@@@@@@S@@
@@@@@@@@@@@@@@@.@@@@@@S@@
@@@@@@@@@@@@@@@@@@@@@@S@@
@@.....................@@
@@.....................@@
@@.....................@@
@@.....................@@
@@.....................@@
@@.....................@@
@@.....................@@
@@.....................@@
@@S@@@@@@@@@@@@@@@@@@@S@@
@@.....................@@
@@@@@@@@@@@@@@@@@@@@@@@@@
@@@@@@@@@@@@@@@@@@@@@@@@@
@@@@@@@@@@@@@@@@@@@@@@@@@
