type octile
height 50
width 50
map
@@@@@@@@@@@@@@@@@@@@@@@@@@@@@@@@@@@@@@@@@@@@@@@@@@
@................................................@
@................................................@
@................................................@
@................................................@
@........................................TTT.....@
@........................................TTT.....@
@........................................TTT.....@
@........................................TTT.....@
@........................................TTT.....@
@........................................TTT.....@
@........................................TTT.....@
@........................................TTT.....@
@........................................TTT.....@
@........................................TTT.....@
@........................................TTT.....@
@........................................TTT.....@
@........................................TTT.....@
@........................................TTT.....@
@........................................TTT.....@
@........................................TTT.....@
@........................................TTT.....@
@........................................TTT.....@
@........................................TTT.....@
@........................................TTT.....@
@........................................TTT.....@
@........................................TTT.....@
@........................................TTT.....@
@........................................TTT.....@
@........................................TTT.....@
@........................................TTT.....@
@........................................TTT.....@
@........................................TTT.....@
@........................................TTT.....@
@........................................TTT.....@
@........................................TTT.....@
@........................................TTT.....@
@........................................TTT.....@
@........................................TTT.....@
@........................................TTT.....@
@........................................TTT.....@
@........................................TTT.....@
@....TTTTTTTTTTTTTTTTTTTTTTTTTTTTTTTTTTTTTTT.....@
@....TTTTTTTTTTTTTTTTTTTTTTTTTTTTTTTTTTTTTTT.....@
@....TTTTTTTTTTTTTTTTTTTTTTTTTTTTTTTTTTTTTTT.....@
@................................................@
@................................................@
@................................................@
@................................................@
@@@@@@@@@@@@@@@@@@@@@@@@@@@@@@@@@@@@@@@@@@@@@@@@@@
