type octile
height 11
width 11
map
@@@@@@@@@@@
@@@@@@@@@@@
@@@@@@@@@@@
@@@@@@@@@@@
@.t.tssssss
@..g.@s@s@s
@.T.tSSs@ss
@@@t@@s@s@s
@@@s@@s@@@s
@@@s@@sssss
@@@@@@@@@@@
