type octile
height 11
width 11
map
@@@@@@@@@@@
@@@@@@@@@@@
@@@@@@@@@@@
@@@@@@@@@@@
@G.......T@
@.@@@@@@..@
@.@@@@@@@.@
@........SS
@@@@@@@...@
@@@@@@@@@@@
@@@@@@@@@@@
