type octile
height 11
width 11
map
@@@@@@@@@@@
@@@@@@@@@@@
@@@@@@@@g@@
@@@@@@@@t@@
@@@@@@sssss
@@@@@@s@s@s
@@@ssSSs@ss
@@@s@@s@s@s
@@@ssss@@@s
@@@s@@sssss
@@@ssss@@@@
