type octile
height 11
width 11
map
@@@@@@@@@@@
@@@@@@@@@@@
@@@@@@@@@@@
@@@@@@@@@@@
@Gt.t@@@@@@
@....@@@@@@
@.T.t....SS
@@@@@@@@@@@
@@@@@@@@@@@
@@@@@@@@@@@
@@@@@@@@@@@
