type octile-corner
height 97
width 97
map
2222222222222222222222222222222222222222222000000222222222222222222222222222222222222222222222222
2222222222222222222222222222222222222222220000002222222222222222222222222222222222222222222222222
2222222222222222222222222222222222222222222000002222222222222222222222222222222222222222222222222
2222222222222222222222222222222222222222222000022222222222222222222222222222222222222222222222222
2222222222222222222222222222222222222222220000022222222222222222222222222222222222222222222222222
2222222222222222222222222222222222222222222000002222222222222222222222222222222222222222222222222
2222222222222222222222222222222222222222222000002222222222222222222222222222222222222222222222222
2222222222222222222222222222222222222222222000002222222222222222222222222222222222222222222222222
2222222222222222222222222222222222222222222000002222222222222222222222222222222222222222222222222
2222222222222222222222222222222222222222222000002222222222222222222222222222222222222222222222222
2222222222222222222222222222222222222222222200022222222222222222222222222222222222222222222222222
2222222222222222222222222222222222222222222200222222222222222222222222222222222222222222222222222
2222222222222222222222222222222222222222222000222222222222222222222222222222222222222222222222222
2222222222222222222222222222222222222222222000002222222222222222222222222222222222222222222222222
2222222222222222222222222222222222222222222200022222222222222222222222222222222222222222222222222
2222222222222222222222222222222222222222222200022222222222222222222222222222222222222222222222222
2222222222222222222222222222222222222222222200222222222222222222222222222222222222222222222222222
2222222222222222222222222222222222222222222220222222222222222222222222222222222222222222222222222
2222222222222222222222222222222222222222222220022222222222222222222222222222222222222222222222222
2222222222222222222222222222222222222222222220022222222222222222222222222222222222222222222222222
2222222222222222222222222222222222222222222200022222222222222222222222222222222222222222222222222
2222222222222222222222222222222222222222222200022222222222222222222222222222222222222222222222222
2222222222222222222222222222222222222222222220222222222222222222222222222222222222222222222222222
2222222222222222222222222222222222222222222220222222222222222222222222222222222222222222222222222
2222222222222222222222222222222222222222222220222222222222222222222222222222222222222222222222222
2222222222222222222222222222222222222222222200022222222222222222222222222222222222222222222222222
2222222222222222222222222222222222222222222200002222222222222222222222222222222222222222222222222
2222222222222222222222222222222222222222222222002222222222222222222222222222222222222222222222222
2222222222222222222222222222222222222222222222002222222222222222222222222222222222222222222222222
2222222222222222222222222222222222222222222222200222222222222222222222222222222222222222222222222
2222222222222222222222222222222222222222222222002222222222222222222222222222222222222222222222222
2222222222222222222222222222222222222222222222202222222222222222222222222222222222222222222222222
2222222222222222222222222222222222222222222222202222222222222222222222222222222222222222222222222
2222222222222222222222222222222222222222222222002222222222222222222222222222222222222222222222222
2222222222222222222222222222222222222222222222200022222222222222222222222222222222222222222222222
2222222222222222222222222222222222222222222222222002222222222222222222222222222222222222222222222
2222222222222222222222222222222222222222222222222202222222222222222222222222222222222222222222222
2222222222222222222222222222222222222222222222222200022222222222222222222222222222222222222222222
2222222222222222222222222222222222222222222222222220022222222222222222222222222222222222222222222
2222222222222222222222222222222222222222222222222220002222222222222222222222222222222222222222222
2222222222222222222222222222222222222222222222222222202222222222222222222222222222222222222222222
2222222222222222222222222222222222222220022222222222220222222222222222222222222222222222222222222
2222222222222222202222222222222222222220000002222222220222222222222222222222222222222222222222222
2222222222222000002220222222222022222200000022222222222222222222222222222222222222222222222222222
0000000000000000000220002200220022200000022022222222222222222222222222222222222222222222222222222
0000000000000000000000000000000000000000222222222222222222222222222222222222222222222222222222222
0000000000000000002200022200000000002222222222222222222222222220002222222222222222222222222222222
2222222222220000222222222222200022222222222222222222222222222200000002222222222222222222222222222
2222222222222002222222222222222222222222222222222222222222222000000002222000022222200000222222222
2222222222222222222222222222222222222222222222222222222202200002222000000000000202200000000000000
2222222222222222222222222222222222222222222222222222222200002022222200000220000000000000000000000
2222222222222222222222222222222222222222222222222222222222022222222202222222200002222222222222222
2222222222222222222222222222222222222222222222202222222222222222222222222222222022222222222222222
2222222222222222222222222222222222222222222222000022222222222222222222222222222222222222222222222
2222222222222222222222222222222222222222222222200022222222222222222222222222222222222222222222222
2222222222222222222222222222222222222222222222202222222222222222222222222222222222222222222222222
2222222222222222222222222222222222222222222222200222222222222222222222222222222222222222222222222
2222222222222222222222222222222222222222222222000222222222222222222222222222222222222222222222222
2222222222222222222222222222222222222222222222000222222222222222222222222222222222222222222222222
2222222222222222222222222222222222222222222220000022222222222222222222222222222222222222222222222
2222222222222222222222222222222222222222222222002222222222222222222222222222222222222222222222222
2222222222222222222222222222222222222222222222002222222222222222222222222222222222222222222222222
2222222222222222222222222222222222222222222222202222222222222222222222222222222222222222222222222
2222222222222222222222222222222222222222222222200222222222222222222222222222222222222222222222222
2222222222222222222222222222222222222222222222200022222222222222222222222222222222222222222222222
2222222222222222222222222222222222222222222222200222222222222222222222222222222222222222222222222
2222222222222222222222222222222222222222222222000222222222222222222222222222222222222222222222222
2222222222222222222222222222222222222222222222002222222222222222222222222222222222222222222222222
2222222222222222222222222222222222222222222222000222222222222222222222222222222222222222222222222
2222222222222222222222222222222222222222222222200222222222222222222222222222222222222222222222222
2222222222222222222222222222222222222222222222200222222222222222222222222222222222222222222222222
2222222222222222222222222222222222222222222222200222222222222222222222222222222222222222222222222
2222222222222222222222222222222222222222222222000022222222222222222222222222222222222222222222222
2222222222222222222222222222222222222222222222000222222222222222222222222222222222222222222222222
2222222222222222222222222222222222222222222222000222222222222222222222222222222222222222222222222
2222222222222222222222222222222222222222222222202222222222222222222222222222222222222222222222222
2222222222222222222222222222222222222222222222202222222222222222222222222222222222222222222222222
2222222222222222222222222222222222222222222222202222222222222222222222222222222222222222222222222
2222222222222222222222222222222222222222222222200222222222222222222222222222222222222222222222222
2222222222222222222222222222222222222222222220000222222222222222222222222222222222222222222222222
2222222222222222222222222222222222222222222220000222222222222222222222222222222222222222222222222
2222222222222222222222222222222222222222222220000022222222222222222222222222222222222222222222222
2222222222222222222222222222222222222222222200000022222222222222222222222222222222222222222222222
2222222222222222222222222222222222222222222200000222222222222222222222222222222222222222222222222
2222222222222222222222222222222222222222222220000222222222222222222222222222222222222222222222222
2222222222222222222222222222222222222222222222000222222222222222222222222222222222222222222222222
2222222222222222222222222222222222222222222222000222222222222222222222222222222222222222222222222
2222222222222222222222222222222222222222222222000222222222222222222222222222222222222222222222222
2222222222222222222222222222222222222222222222000222222222222222222222222222222222222222222222222
2222222222222222222222222222222222222222222222000222222222222222222222222222222222222222222222222
2222222222222222222222222222222222222222222222000222222222222222222222222222222222222222222222222
2222222222222222222222222222222222222222222222000222222222222222222222222222222222222222222222222
2222222222222222222222222222222222222222222222000222222222222222222222222222222222222222222222222
2222222222222222222222222222222222222222222222000222222222222222222222222222222222222222222222222
2222222222222222222222222222222222222222222222000222222222222222222222222222222222222222222222222
2222222222222222222222222222222222222222222222000222222222222222222222222222222222222222222222222
2222222222222222222222222222222222222222222222000222222222222222222222222222222222222222222222222
GGGGGGGGGGGGGGGGGGGGGGGGGGGGGGGGGGGGGGGGGGGWWOWWWGGGGGGGGGGGGGGGGGGGGGGGGGGGGGGGGGGGGGGGGGGGGGGGG
OOOOOOOOOOOOOOOOOOOOOOOOOOOOOOOOOOOOOOOOOOOOOOOOOOOOOOOOOOOOOOOOOOOOOOOOOOOOOOOOOOOOOOOOOOOOOOOOG
OOOOOOOOOOOOOOOOOOOOOOOOOOOOOOOOOOOOOOOOOOOOOOOOOOOOOOOOOOOOOOOOOOOOOOOOOOOOOOOOOOOOOOOOOOOOOOOOG
OOOOOOOOOOOOOOOOOOOOOOOOOOOOOOOOOOOOOOOOOOOOOOOOOOOOOOOOOOOOOOOOOOOOOOOOOOOOOOOOOOOOOOOOOOOOOOOOG
OOOOOOOOOOOOOOOOOOOOOOOOOOOOOOOOOOOOOOOOOOOOOOOOOOOOOOOOOOOOOOOOOOOOOOOOOOOOOOOOOOOOOOOOOOOOOOOOG
OOOOOOOOOOOOOOOOOOOOOOOOOOOOOOOOOOOOOOOOOOOOOOOOOOOOOOOOOOOOOOOOOOOOOOOOOOOOOOOOOOOOOOOOOOOOOOOOG
OOOOOOOOOOOOOOOOOOOOOOOOOOOOOOOOOOOOOOOOOOOOOOOOOOOOOOOOOOOOOOOOOOOOOOOOOOOOOOOOOOOOOOOOOOOOOOOOG
OOOOOOOOOOOOOOOOOOOOOOOOOOOOOOOOOOOOOOOOOOOOOOOOOOOOOOOOOOOOOOOOOOOOOOOOOOOOOOOOOOOOOOOOOOOOOOOOG
OOOOOOOOOOOOOOOOOOOOOOOOOOOOOOOOOOOOOOOOOOOOOOOOOOOOOOOOOOOOOOOOOOOOOOOOOOOOOOOOOOOOOOOOOOOOOOOOG
OOOOOOOOOOOOOOOOOOOOOOOOOOOOOOOOOOOOOOOOOOOOOOOOOOOOOOOOOOOOOOOOOOOOOOOOOOOOOOOOOOOOOOOOOOOOOOOOG
OOOOOOOOOOOOOOOOOOOOOOOOOOOOOOOOOOOOOOOOOOOOOOOOOOOOOOOOOOOOOOOOOOOOOOOOOOOOOOOOOOOOOOOOOOOOOOOOG
OOOOOOOOOOOOOOOOOOOOOOOOOOOOOOOOOOOOOOOOOOOOOOOOOOOOOOOOOOOOOOOOOOOOOOOOOOOOOOOOOOOOOOOOOOOOOOOOG
OOOOOOOOOOOOOOOOOOOOOOOOOOOOOOOOOOOOOOOOOOOOOOOOOOOOOOOOOOOOOOOOOOOOOOOOOOOOOOOOOOOOOOOOOOOOOOOOG
OOOOOOOOOOOOOOOOOOOOOOOOOOOOOOOOOOOOOOOOOOOOOOOOOOOOOOOOOOOOOOOOOOOOOOOOOOOOOOOOOOOOOOOOOOOOOOOOG
OOOOOOOOOOOOOTTTTTTTTTTTTTTTTTTTTTTTTTTTTTGGSOSGGTTTTTTTTTTTTTTTTTTTTTTTTTTTTTTTTTTTOOOOOOOOOOOOG
OOOOOOOOOOOOOTTTTTTTTTTTTTTTTTTTTTTTGGGGGTTGSOSTTTTTTTTTTTTTTTTTTTTTTTTTTTTTTTTTTTTOOOOOOOOOOOOOG
OOOOOOOOOOOOOTTTTTTTTTTTTTTTTTTTTTTGGGGGGTTGSOGGTTTTTTTTTTTTTTTTTTTTTTTTTTTTTTTTTTTTOOOOOOOOOOOOG
OOOOOOOOOOOOOTTTTTTTGGTTTTTTTTTTTTTGGGGGGGTGGSGGTTGTTTTTTTTTTTTTTTTTTGGTGTTTTTTTTTTOOOOOOOOOOOOOG
OOOOOOOOOOOOOTTTTTGGGGGGTTTTTTTTTTTGGGGGGGTTGSSGTTTTTTTTTTTTTTTTTTTTTTGGGGTTTTTTTTTTOOOOOOOOOOOOG
OOOOOOOOOOOOOTTTTTGGGGGGGGGTTTTTTTTGGGGGGGGTGSSTTTTTTTTTTTTTTTTTTTTTTGGGGGGTTTTTTTTOOOOOOOOOOOOOG
OOOOOOOOOOOOOTTTTGGGGGGGGGGGTTTTTGGGGGGGGGTGSSSGTTTTGGTGGTTTTTTTTTTTGGGGGGGGGTTTTTTTOOOOOOOOOOOOG
OOOOOOOOOOOOOTTTTGGGGGGGGGGGGTTTTTGGGGGGGGGGSSSTTTTGGGGGGGTTTTTTTTTGGGGGGGGGGGTTTTTOOOOOOOOOOOOOG
OOOOOOOOOOOOOTTTTTGGGGGGGGGGGGTTTTGGGGGGGGGGGSGGTTTTGGGGGGGGTTTTTTTGGGGGGGGGGGGTTTTTOOOOOOOOOOOOG
OOOOOOOOOOOOOTTTTTTGGGGGGGGGGGGGTTTGGGGGGGGGGWGTTTTGGGGGGGGTTTTTTGGGGGGGGGGGGGGTTTTOOOOOOOOOOOOOG
OOOOOOOOOOOOOTTTTTGGGGGGGGGGGGGGTTTTGGGGGGGGGWGGGTTGGGGGGGGGTTTTGGGGGGGGGGGGGGGGGTTTOOOOOOOOOOOOG
OOOOOOOOOOOOOTTTTGGGGGGGGGGGGGGGGTTTTGGGGGGGWWWGTTTTGGGGGGGTTTGGGGGGGGGGGGGGGGGGTTTOOOOOOOOOOOOOG
OOOOOOOOOOOOOTTTTGGGGGGGGGGGGGGGGGTTTTGGTGTGWWWWGTTTTGGGGGGTTTTGGGGGGGGGGGGGGGGGTTTTOOOOOOOOOOOOG
OOOOOOOOOOOOOTTTTTGGGGGGGGGGGGGGGGGTTTTTTTTGGGWWTTTTGGGGGGGTTTTGGGGGGGGGGGGGGGGGTTTOOOOOOOOOOOOOG
OOOOOOOOOOOOOTTTTTGGGGGGGGGGGGGGGGGGTTTTTTTTTGWWGGTTGGGGGGGGTTTGGGGGGGGGGGGGGGGGGTTTOOOOOOOOOOOOG
OOOOOOOOOOOOOTTTTTTTGGGGGGGGGGGGGGGGGGGTTTTTTGGWWTTTTGGGGGGTTTGGGGGGGGGGGGGGGGGTTTTOOOOOOOOOOOOOG
OOOOOOOOOOOOOTTTTTTTGGGGGGGGGGGGGGGGGGGGTGTTTGSWGGTTTTGGGGGGTTGGGGGGGGGGGGGGGGGTTTTTOOOOOOOOOOOOG
OOOOOOOOOOOOOTTTTTTTGGGGGGGGGGGGGGGGGGGGGGGTTGGWGTTTTGGGGGGGGGGGGGGGGGGGGGGGGGGTTTTOOOOOOOOOOOOOG
OOOOOOOOOOOOOTTTTTGGTGGTGGGGGGGGGGGGGGGGGGGTTGGWGGTTTGGGGGGGGGGGGGGGGGGGGGGGGGGGGTTTOOOOOOOOOOOOG
OOOOOOOOOOOOOTTTTTTTTTTTTTGGGGGGGGGGGGGGGGTTTGWWTTTTTTGGGGGGGGGGGGGGGGGGGGGGGGGGTTTOOOOOOOOOOOOOG
OOOOOOOOOOOOOTTTTTTTTTTTTTGGGGGGGGGGGGGGGGGTTGGWWWGTTTTGGGGGGGGGGGGGGGGGGGGGGGTGTTTTOOOOOOOOOOOOG
OOOOOOOOOOOOOTTTTTTTTTTTTTTGGGGGGGGGGGGGGGGTTTGGGWWTTTTTGGGGGGGGGGGGGGGGGGGTTTTTTTTOOOOOOOOOOOOOG
OOOOOOOOOOOOOTTTTTTTTTTTTTTGGGGGGGGGGGGGGTTTTGGGGGWGTTTTTGGGGGGGGGGGGGGGGGTTTTTTTTTTOOOOOOOOOOOOG
OOOOOOOOOOOOOTTTTTTTTGGGGTTGGGGGGGGGGGGGGTTTGGGGGGWWWTTTGGGGGGGGGGGGGGGGTTTTTTTTTTTOOOOOOOOOOOOOG
OOOOOOOOOOOOOTTTTTTTGGGGGGGGGGGGGGGGGGGTTTTGGGGGGGGWWGTTTGGGGGGGGGGGGGTTTTTTTTTTTTTTOOOOOOOOOOOOG
OOOOOOOOOOOOOTTTTTTGGGGGGGGGGGGGGGGGGGGTTTGGGGGGGGGWWWTTTTTGGGGGGGGGGTTTTGGGGGTTTTTOOOOOOOOOOOOOG
OOOOOOOOOOOOOTTTTTTGGGGGGGGGGGGTTTTGGTTTTGGGGGGGGGGGGWGTTTTTGGGGGGGGGTTTTGGGGGGTTTTTOOOOOOOOOOOOG
OOOOOOOOOOOOOTTTTTTGGGGGGGGGGGTTTTTTTTGSSGGGGGGGGGGGGGWGGTTTTGGGGGGTTTTGGGGGGGGGTTTOOOOOOOOOOOOOG
OOOOOOOOOOOOOTTTGWTTGGGGGGGGGTTTTTTTTTGSSSWWWGGGGGGGGGWGGGGTTTGGGGGTTTTGGGGGGGGGGTTTOOOOOOOOOOOOG
OOOOOOOOOOOOOWWWWWGTGWGTGGGGGGGSGTTTTGSSSSWWGGGGGGGGGGGGGGGTTTTGGGTTTTGGGGGGGGGGGGTOOOOOOOOOOOOOG
OOOOOOOOOOOOOWWWWWWTGWWWGGSSGGSSTTGSSSSSSGGWGGGGGGGGGGGGGGGGGTTTGGTTTTGGGGGGGGGGGGTTOOOOOOOOOOOOG
OOOOOOOOOOOOOWWWWWWWWWWWWSSSSSSSSSSSSSSSGGGGGGGGGGGGGGGGGGGGGTTTTTTTTGGGGGGGGGGGGGTOOOOOOOOOOOOOG
OOOOOOOOOOOOOWWWWWGGWWWGGGSSSSSSSSSSGGGGGGGGGGGGGGGGGGGGGGGGGGGWWWGTTGGGGGGGGGGGGGTTOOOOOOOOOOOOG
OOOOOOOOOOOOOWWWGGGGGGGTTGGGGSSSGGGGTTTTGGGGGGGGGGGGGGGGGGGGGGWWWWWWWGGGGGGGGGTTTTTOOOOOOOOOOOOOG
OOOOOOOOOOOOOWWGGTTGGGGGTTTTGGGGGTTTTTTTTGGGGGGGGGGGGGGGGGGGGWWWWWWWWGGGGWWWWGGTTTGOOOOOOOOOOOOOG
OOOOOOOOOOOOOGGTTTGGGGGGGTTTTTTTTTTTTTTTTTGGGGGGGGGGGGGGWGGWWWWGGGGWWWWWWWWWWWWGOOOOOOOOOOOOOOOOO
OOOOOOOOOOOOOTTTTTGGGGGGGGGTTTTTTTTTGGTGTTTGGGGGGGGGGGGGWWWWGWGGTTGGWWWWWGGWWWWWWWWOOOOOOOOOOOOOS
OOOOOOOOOOOOOTTTGGGGGGGGGGGGTTTGGTGGGGGGTTTTGGGGGGGGGGGGGGWGGGTTTTTGWGGGGTGGGWWWWGGOOOOOOOOOOOOOG
OOOOOOOOOOOOOTTTGGGGGGGGGGGGTTTTTGGGGGGGGGTTTGGWGGGGGGGGGGGGTTTTTTTGGGTTTTTTGGGWGTGOOOOOOOOOOOOOG
OOOOOOOOOOOOOTTTGGGGGGGGGGGGTTTTTGGGGGGGGGTTGGWWWWGGGGGGGTTTTTTTTTGTTTTTTTTGTTGGGTTTOOOOOOOOOOOOG
OOOOOOOOOOOOOTTTGGGGGGGGGGGGTTTTTGGGGGGGGGGTTGGWWWGGGGGGTTTTTTTTTGGGGTGGGTGTTTTTTTTOOOOOOOOOOOOOG
OOOOOOOOOOOOOTTTGGGGGGGGGGGTTTTGGGGGGGGGGGGGTTGSGGGGGGGTTTGGGTTGGGGGGGGGGGGGTGTGTGTTOOOOOOOOOOOOG
OOOOOOOOOOOOOGTTTGGGGGGGGTTTTTTGGGGGGGGGGGGGTTGSSGGGGGTTTTGGGGGGGGGGGGGGGGGGGGGTTTTOOOOOOOOOOOOOG
OOOOOOOOOOOOOTTTTTGGGTGTTTTTTTGGGGGGGGGGGGGGTGSSSGGTTTTTGGGGGGGGGGGGGGGGGGGGGGTTTTTOOOOOOOOOOOOOG
OOOOOOOOOOOOOTTTTTTTTTTTTTTTTGGGGGGGGGGGGGGGTGSSSGGTTTTTGGGGGGGGGGGGGGGGGGGGGGGTTTTOOOOOOOOOOOOOG
OOOOOOOOOOOOOTTTTTTTTTTTTTTGGGGGGGGGGGGGGGGGGSSSSSTTTGGGGGGGGGGGGGGGGGGGGGGGGGGGTTGOOOOOOOOOOOOOG
OOOOOOOOOOOOOTTTTTTTTTTTGTGGGGGGGGGGGGGGGGGTGGSSGGGTTGGGGGGGGGGGGGGGGGGGGGGGGGGGTTTTOOOOOOOOOOOOG
OOOOOOOOOOOOOTTTTTTTGTGGGGGGGGGGGGGGGGGGGGGGTGSSTTTTTGGGGGGGGGGGGGGGGGGGGTGGGTGTTTTOOOOOOOOOOOOOG
OOOOOOOOOOOOOTTTTTTGGGGGGGGGGGGGGGGGGGGGGGGGTGGWGTTTTGGGGGGGGGGGGGGGGGGGTTTTTTTTTTTTOOOOOOOOOOOOG
OOOOOOOOOOOOOTTTTTTGGGGGGGGGGGGGGGGGGGGGGGGTTTGWWTTGGGGGGGGGGGGGGGGGGGGTTTTTTTTTTTGOOOOOOOOOOOOOG
OOOOOOOOOOOOOTTTTTTGGGGGGGGGGGGGGGGGGGGGGGGGTTGWWWGTGGGGGGGGGGGGGGGGGGGGTTTTTTTTTTTOOOOOOOOOOOOOG
OOOOOOOOOOOOOTTTTTTGGGGGGGGGGGGGGGGGGGGGGGGGTTGWWGTTGGGGGGGGGGGGGGGGGGGGGTGGGTTTTTTOOOOOOOOOOOOOG
OOOOOOOOOOOOOTTTTTTTGGGGGGGGGGGGGGGGGGGGGGGTTGWWWGTTTGGGGGGGGGGGGGGGGGGGGGGGTTGTTTTTOOOOOOOOOOOOG
OOOOOOOOOOOOOTTTTTTTTGGGGGGGGGGGGGGGGGGGGGTTTGWWGTTTTTGGGGGGGGGGGGGGGGGGGGGGGTTTTTGOOOOOOOOOOOOOG
OOOOOOOOOOOOOTTTTTTTTTGGGGGGGGGGGGGTGGGGGGGTTGWWWGTTTTTTTTGGGGGGGGGGGGGGGGGGGGTGTTTTOOOOOOOOOOOOG
OOOOOOOOOOOOOTTTTTTTTGGGGGGGGGGGGTTTTGGGGGGGTGGWWTTTTTTTTTTGGGGGGGGGGGGGGGGGGGGTTTTOOOOOOOOOOOOOG
OOOOOOOOOOOOOTTTTTTTGGGGGGGGGGGGGTTTTTGGGGGGTTGWWGTTTGGTTTTTGGGGGGGGGGGGGGGGGGGTTTTTOOOOOOOOOOOOG
OOOOOOOOOOOOOTTTTTTTGGGGGGGGGGGGGTTTTGGGGGGTTTGWWTTGGGGGTTTTGGGGGGGGGGGGGGGGGGTTTTGOOOOOOOOOOOOOG
OOOOOOOOOOOOOTTTTTTTGGGGGGGGGGGGGGTTGGGGGGGGTGWWWWTGGGGGGGTTTGGGGGGGGGGGGGGGGGGTTTTTOOOOOOOOOOOOG
OOOOOOOOOOOOOTTTTGGGGGGGGGGGGGGGTTTTGGGGGGGGTGWWWGGGGGGGGGTTTGGGGGGGGGGGGGGGGGGTTTTOOOOOOOOOOOOOG
OOOOOOOOOOOOOTTTTTGGGGGGGGGGGGGGTTTTTGGGGGGGTGWWWGTGGGGGGGGTTTGGGGGGGGGGGGGGGGGGTTTTOOOOOOOOOOOOG
OOOOOOOOOOOOOTTTTTGGGGGGGGGGGGGGTTTTGGGGGGGGTGGWGTGGGGGGGGGTTTGGGGGGGGGGGGGGGGGGGTGOOOOOOOOOOOOOG
OOOOOOOOOOOOOTTTTTGGGGGGGGGGGGGGGGTTGGGGGGGGGTGWGTTGGGGGGGGGTTTGGGGGGGGGGGGGGGGGTTTTOOOOOOOOOOOOG
OOOOOOOOOOOOOTTTTGGGGGGGGGGGGGGGGTTTTGGGGGGGTTGWTTTGGGGGGGGTTTTGGGTGGGGGGGGGGGGTTTTOOOOOOOOOOOOOG
OOOOOOOOOOOOOTTTTTGGGGGGGGGGGGGGGTTTTTGGGGGGTTGWWGTGGGGGGGGGGTTTTTTTTGGGGGGGGGGGTTTTOOOOOOOOOOOOG
OOOOOOOOOOOOOTTTTGGGGGGGGTTGGGGGTTTTTTGGGGTTGWWWWTTTGGGGGGGGTTTTTTTTTGGGGGGGGGGGGTGOOOOOOOOOOOOOG
OOOOOOOOOOOOOGTTTTTTGTGGGTTTGTGGTTTTTTTGGTTTGWWWWGTTTTGGGGGGGTTTTTTTTTGGGTGGGTGGTTTTOOOOOOOOOOOOG
OOOOOOOOOOOOOTTTTTTTTTTTTTTTTTTTTTTTTTTTTTTTGWWWWWTTTTGGGGGTTTTTTTTTTTTTTTTTTTTTTTTOOOOOOOOOOOOOG
OOOOOOOOOOOOOGTTTTTTTTTTTTTTTTTTTTTTTTTTTTTGWWWWWWGTTTTTTTTTTTTTTTTTTTTTTTTTTTTTTTTTOOOOOOOOOOOOG
OOOOOOOOOOOOOTTTTTTTTTTTTTTTTTTTTTTTTTTTTTTGWWWWWGGTTTTTTTTTTTTTTTTTTTTTTTTTTTTTTTGTOOOOOOOOOOOOG
OOOOOOOOOOOOOOOOOOOOOOOOOOOOOOOOOOOOOOOOOOOOOOOOOOOOOOOOOOOOOOOOOOOOOOOOOOOOOOOOOOOOOOOOOOOOOOOOG
OOOOOOOOOOOOOOOOOOOOOOOOOOOOOOOOOOOOOOOOOOOOOOOOOOOOOOOOOOOOOOOOOOOOOOOOOOOOOOOOOOOOOOOOOOOOOOOOG
OOOOOOOOOOOOOOOOOOOOOOOOOOOOOOOOOOOOOOOOOOOOOOOOOOOOOOOOOOOOOOOOOOOOOOOOOOOOOOOOOOOOOOOOOOOOOOOOG
OOOOOOOOOOOOOOOOOOOOOOOOOOOOOOOOOOOOOOOOOOOOOOOOOOOOOOOOOOOOOOOOOOOOOOOOOOOOOOOOOOOOOOOOOOOOOOOOG
OOOOOOOOOOOOOOOOOOOOOOOOOOOOOOOOOOOOOOOOOOOOOOOOOOOOOOOOOOOOOOOOOOOOOOOOOOOOOOOOOOOOOOOOOOOOOOOOG
OOOOOOOOOOOOOOOOOOOOOOOOOOOOOOOOOOOOOOOOOOOOOOOOOOOOOOOOOOOOOOOOOOOOOOOOOOOOOOOOOOOOOOOOOOOOOOOOG
OOOOOOOOOOOOOOOOOOOOOOOOOOOOOOOOOOOOOOOOOOOOOOOOOOOOOOOOOOOOOOOOOOOOOOOOOOOOOOOOOOOOOOOOOOOOOOOOG
OOOOOOOOOOOOOOOOOOOOOOOOOOOOOOOOOOOOOOOOOOOOOOOOOOOOOOOOOOOOOOOOOOOOOOOOOOOOOOOOOOOOOOOOOOOOOOOOG
OOOOOOOOOOOOOOOOOOOOOOOOOOOOOOOOOOOOOOOOOOOOOOOOOOOOOOOOOOOOOOOOOOOOOOOOOOOOOOOOOOOOOOOOOOOOOOOOG
OOOOOOOOOOOOOOOOOOOOOOOOOOOOOOOOOOOOOOOOOOOOOOOOOOOOOOOOOOOOOOOOOOOOOOOOOOOOOOOOOOOOOOOOOOOOOOOOG
OOOOOOOOOOOOOOOOOOOOOOOOOOOOOOOOOOOOOOOOOOOOOOOOOOOOOOOOOOOOOOOOOOOOOOOOOOOOOOOOOOOOOOOOOOOOOOOOG
OOOOOOOOOOOOOOOOOOOOOOOOOOOOOOOOOOOOOOOOOOOOOOOOOOOOOOOOOOOOOOOOOOOOOOOOOOOOOOOOOOOOOOOOOOOOOOOOG
OOOOOOOOOOOOOOOOOOOOOOOOOOOOOOOOOOOOOOOOOOOOOOOOOOOOOOOOOOOOOOOOOOOOOOOOOOOOOOOOOOOOOOOOOOOOOOOOG
