type octile
height 15
width 15
map
..@..........@@
..@..........@@
..@@@@@@@@@..@@
..........@..@@
..........@..@@
..@..@@@@.@..@@
..@..@....@..@@
@@@@@@.@@@@..@@
@@@@@@.@@@@..@@
.....@.@@....@@
..@@@@.@@@@..@@
.............@@
.............@@
@@@@@@@@@@@@@@@
@@@@@@@@@@@@@@@
